,State name,District name,Population,Literate,Male_Literate,Female_Literate,Households_with_Internet,Rural_Households,Urban_Households,Households,Workers,Male_Workers,Female_Workers,literacy_rate,internet_rate,rural_rate,urban_rate,activity_rate,female_activity,male_activity,male_literate,female_literate
0,JAMMU AND KASHMIR,Kupwara,870354,439654,282823,156831,762,158438,23226,181664,229064,190899,38165,50.51438839828391,0.41945569843227054,87.2148581997534,12.78514180024661,26.318486500895037,16.661282436349666,83.33871756365033,64.32854017022477,35.67145982977523
1,JAMMU AND KASHMIR,Badgam,753745,335649,207741,127908,1999,160649,27190,187839,214866,162578,52288,44.53084265898944,1.0642092430219496,85.5248377599966,14.475162240003407,28.506457754280294,24.33516703433768,75.66483296566233,61.89233395600762,38.10766604399238
2,JAMMU AND KASHMIR,Leh(Ladakh),133487,93770,62834,30936,574,36920,17474,54394,75079,53265,21814,70.24654086165694,1.055263448174431,67.87513328675956,32.12486671324043,56.24442829638841,29.0547290187669,70.9452709812331,67.00863815719313,32.99136184280687
3,JAMMU AND KASHMIR,Kargil,140802,86236,56301,29935,235,40370,7774,48144,51873,39839,12034,61.246289115211425,0.488118976404121,83.85260884014623,16.147391159853772,36.84109600715899,23.198966707150156,76.80103329284984,65.28711906860244,34.712880931397564
4,JAMMU AND KASHMIR,Punch,476835,261724,163333,98391,346,132139,15269,147408,161393,117677,43716,54.88774943114495,0.23472267448171064,89.64167480733745,10.35832519266254,33.84671846655552,27.086676621662647,72.91332337833735,62.4065809784353,37.5934190215647
5,JAMMU AND KASHMIR,Rajouri,642415,364109,224469,139640,673,196070,17508,213578,290912,184752,106160,56.678159756543664,0.31510736124507205,91.80252647744618,8.197473522553821,45.28412319139497,36.49213507864921,63.50786492135079,61.64884691122713,38.35115308877287
6,JAMMU AND KASHMIR,Kathua,616435,389204,228499,160705,1443,181374,33473,214847,200431,161548,38883,63.1378815284661,0.6716407489981243,84.42007568176423,15.579924318235769,32.51453924582478,19.399693660162352,80.60030633983764,58.70931439553551,41.29068560446449
7,JAMMU AND KASHMIR,Baramula,1008039,545149,337170,207979,3698,210543,48932,259475,304200,249581,54619,54.080149676748626,1.4251854706619134,81.14192118701223,18.858078812987763,30.17740385044626,17.954963839579225,82.04503616042078,61.849145829855686,38.150854170144314
8,JAMMU AND KASHMIR,Bandipore,392232,185979,117058,68921,985,80521,17555,98076,149317,101380,47937,47.41556017866977,1.0043231779436355,82.10061584893347,17.89938415106652,38.068541067531456,32.10418103765814,67.89581896234186,62.94151490222014,37.05848509777986
9,JAMMU AND KASHMIR,Srinagar,1236829,748584,431746,316838,16413,4518,257721,262239,407188,333151,74037,60.52445406761969,6.258794458490156,1.7228558681203026,98.2771441318797,32.92193181110727,18.182510290087134,81.81748970991286,57.67502377822663,42.324976221773376
10,JAMMU AND KASHMIR,Ganderbal,297446,143276,90581,52695,878,63788,13558,77346,100890,73305,27585,48.168743234066014,1.1351588963876607,82.47097458174954,17.52902541825046,33.91876172481727,27.34165923282783,72.65834076717216,63.221335045646164,36.778664954353836
11,JAMMU AND KASHMIR,Pulwama,560440,293958,178326,115632,1537,147520,21703,169223,188420,138428,49992,52.451288273499394,0.9082689705300107,87.1749112118329,12.825088788167093,33.62001284704875,26.532215263772425,73.46778473622759,60.663768293429676,39.336231706570324
12,JAMMU AND KASHMIR,Shupiyan,266215,136500,80355,56145,884,75616,5272,80888,87721,63931,23790,51.27434592340777,1.0928691524082683,93.48234595984572,6.517654040154287,32.95118607140845,27.120073870566912,72.87992612943309,58.86813186813187,41.13186813186813
13,JAMMU AND KASHMIR,Anantnag,1078692,545532,324417,221115,2712,207067,70666,277733,389684,244032,145652,50.57347231647217,0.9764774081581952,74.55613844951806,25.443861550481937,36.12560397221821,37.37695158128124,62.62304841871875,59.46800554321287,40.53199445678713
14,JAMMU AND KASHMIR,Kulgam,424483,209085,125052,84033,838,95952,25178,121130,159990,102317,57673,49.25638953739019,0.6918187071741104,79.21406753075209,20.785932469247914,37.69055533437146,36.047877992374524,63.952122007625476,59.80916851997991,40.19083148002009
15,JAMMU AND KASHMIR,Doda,409936,219083,138620,80463,596,122267,11350,133617,151912,101144,50768,53.443220405136415,0.4460510264412462,91.5055718957917,8.494428104208298,37.057491901174814,33.41934804360419,66.58065195639581,63.27282354176271,36.72717645823729
16,JAMMU AND KASHMIR,Ramban,283713,124065,82938,41127,417,84281,5341,89622,87212,68476,18736,43.72905013164712,0.4652875410055567,94.04052576376336,5.959474236236638,30.739514932343603,21.483282117139844,78.51671788286015,66.85044130093097,33.14955869906904
17,JAMMU AND KASHMIR,Kishtwar,230696,107506,68700,38806,274,72378,5993,78371,82974,56779,26195,46.60072129555779,0.34961911931709433,92.35303875157904,7.646961248420972,35.96681346880744,31.570130402294694,68.4298695977053,63.9034100422302,36.0965899577698
18,JAMMU AND KASHMIR,Udhampur,554985,322354,197543,124811,1214,148664,34696,183360,243672,163845,79827,58.083371622656465,0.662085514834206,81.07766143106457,18.922338568935427,43.90605151490581,32.76002166847237,67.23997833152762,61.2813863020158,38.7186136979842
19,JAMMU AND KASHMIR,Reasi,314667,150542,93937,56605,602,95572,12261,107833,144767,88755,56012,47.84168660838283,0.5582706592601522,88.62964027709513,11.370359722904862,46.00641312879965,38.69113817375507,61.30886182624493,62.399197566127725,37.600802433872275
20,JAMMU AND KASHMIR,Jammu,1529958,1137135,641916,495219,19905,254566,248043,502609,508622,417456,91166,74.32458930245144,3.9603349721155015,50.6489139669206,49.3510860330794,33.24418055920489,17.924116534479438,82.07588346552056,56.4502895434579,43.5497104565421
21,JAMMU AND KASHMIR,Samba,318898,228139,130312,97827,992,94247,19989,114236,92526,81952,10574,71.53980269553274,0.8683777443187787,82.50201337581848,17.497986624181518,29.014292971420332,11.428139117653416,88.57186088234658,57.119563073389465,42.880436926610535
22,HIMACHAL PRADESH,Chamba,519080,323842,186064,137778,1615,186395,13836,200231,294035,158791,135244,62.3876859058334,0.8065684134824278,93.089981071862,6.910018928138001,56.64541111196733,45.99588484364106,54.004115156358935,57.4551787600126,42.5448212399874
23,HIMACHAL PRADESH,Kangra,1510075,1152640,606443,546197,8053,588321,39007,627328,675170,403756,271414,76.32998361008559,1.2836984799020608,93.78204065496837,6.217959345031626,44.71102428687317,40.19935719892768,59.80064280107232,52.61339186563021,47.386608134369794
24,HIMACHAL PRADESH,Lahul AND Spiti,31564,21845,12897,8948,61,17434,0,17434,19295,10763,8532,69.20859206691166,0.34989101755191004,100.0,0.0,61.129768090229376,44.21870951023581,55.78129048976419,59.03868162050813,40.96131837949187
25,HIMACHAL PRADESH,Kullu,437903,307672,174550,133122,2623,167995,20709,188704,269084,148829,120255,70.26030878984615,1.390007630998813,89.02566983211803,10.974330167881973,61.44831161238905,44.690505567034826,55.30949443296517,56.73249434462675,43.267505655373256
26,HIMACHAL PRADESH,Mandi,999777,723747,393669,330078,5333,431129,31696,462825,572671,297464,275207,72.39084315802424,1.1522713768703075,93.15162318370874,6.848376816291254,57.27987341177082,48.056737638190164,51.943262361809836,54.39317883182936,45.60682116817065
27,HIMACHAL PRADESH,Hamirpur,454768,358091,180555,177536,2521,196116,15232,211348,241931,118724,123207,78.74146817718045,1.1928194257811762,92.79292919734277,7.2070708026572285,53.1987738803082,50.92650383787113,49.07349616212887,50.42154089323664,49.57845910676337
28,HIMACHAL PRADESH,Una,521173,399715,213281,186434,2412,185091,20126,205217,215346,141612,73734,76.69526241766171,1.1753412241675885,90.19282028292002,9.80717971707997,41.31948508460722,34.23978156083698,65.76021843916303,53.35826776578312,46.64173223421688
29,HIMACHAL PRADESH,Bilaspur,381956,287620,155599,132021,1574,152458,11987,164445,205871,111543,94328,75.3018672307805,0.9571589285171335,92.71063273434888,7.28936726565113,53.899140215103316,45.818983732531535,54.181016267468465,54.09881093108964,45.90118906891037
30,HIMACHAL PRADESH,Solan,580320,428578,244372,184206,5250,192787,51509,244296,298737,190001,108736,73.85201268265784,2.1490323214461147,78.91533221992992,21.08466778007008,51.4779776674938,36.39857131858457,63.60142868141543,57.01925903802808,42.98074096197191
31,HIMACHAL PRADESH,Sirmaur,529855,362645,205617,157028,2220,171102,21054,192156,280083,169399,110684,68.44230968849968,1.1553113095609817,89.04327733716354,10.956722662836444,52.86031083975805,39.51828565103916,60.48171434896085,56.69925133394918,43.30074866605082
32,HIMACHAL PRADESH,Shimla,814010,612642,342846,269796,9177,279269,95896,375165,430926,258628,172298,75.26222036584316,2.4461237055695495,74.43898018205323,25.561019817946768,52.93866168720286,39.983198971517155,60.016801028482845,55.96188312260668,44.03811687739332
33,HIMACHAL PRADESH,Kinnaur,84121,60699,36697,24002,354,44514,0,44514,56273,33863,22410,72.15677417054005,0.7952554252594689,100.0,0.0,66.89530557173595,39.82371652479875,60.17628347520125,60.457338671147795,39.542661328852205
34,PUNJAB,Gurdaspur,2298323,1634719,907660,727059,14428,420860,185488,606348,757138,637652,119486,71.12659969899792,2.3794916450619117,69.40898625871613,30.591013741283884,32.94306326830476,15.781271049663337,84.21872895033667,55.52391573108283,44.47608426891716
35,PUNJAB,Kapurthala,815168,576567,316254,260313,9732,165433,95770,261203,284165,235562,48603,70.72983728507498,3.7258377583718407,63.335030608377394,36.66496939162261,34.859685365470675,17.10379533017789,82.89620466982211,54.851214169385344,45.148785830614656
36,PUNJAB,Jalandhar,2193590,1622537,882581,739956,39082,330339,377791,708130,774472,639484,134988,73.96719532820627,5.519043113552597,46.6494852640052,53.3505147359948,35.30614198642408,17.42968112468882,82.57031887531117,54.39512319287634,45.60487680712366
37,PUNJAB,Hoshiarpur,1586625,1199699,637927,561772,13747,422673,128592,551265,499822,412506,87316,75.61326715512487,2.4937189917734663,76.67328780169247,23.32671219830753,31.502213818640197,17.469419113204303,82.5305808867957,53.17392112521557,46.82607887478443
38,PUNJAB,Shahid Bhagat Singh Nagar,612310,438459,239155,199304,5264,183168,48383,231551,204329,170252,34077,71.6073557511718,2.2733652629442327,79.10481924068564,20.895180759314364,33.370188303310414,16.677515183845664,83.32248481615434,54.54443859060938,45.45556140939062
39,PUNJAB,Fatehgarh Sahib,600163,426033,238696,187337,5138,117559,57337,174896,214783,182777,32006,70.98621541147988,2.937745860397036,67.21651724453389,32.7834827554661,35.78744441093503,14.901551798792271,85.09844820120773,56.027584717615774,43.97241528238423
40,PUNJAB,Ludhiana,3498739,2560225,1428348,1131877,58589,395032,641789,1036821,1284822,1053600,231222,73.17564985556224,5.650830760565228,38.10030853927534,61.89969146072466,36.722430567127184,17.99642285079178,82.00357714920821,55.78994033727505,44.21005966272495
41,PUNJAB,Moga,995746,627889,348549,279340,7897,214295,74144,288439,359172,292379,66793,63.057145095235136,2.7378405832775736,74.29473822888029,25.70526177111972,36.07064452179572,18.596382791531635,81.40361720846838,55.511244821935094,44.48875517806491
42,PUNJAB,Firozpur,2029074,1227511,707070,520441,10042,348522,153868,502390,756695,596406,160289,60.49611793359927,1.998845518421943,69.37279802543841,30.627201974561597,37.29262708013606,21.18277509432466,78.81722490567535,57.6019278034983,42.3980721965017
43,PUNJAB,Muktsar,901896,524848,300401,224447,4571,149507,74650,224157,335326,272699,62627,58.19384940170485,2.039195742269927,66.69744866321373,33.302551336786266,37.18011832849907,18.676452168934112,81.3235478310659,57.23580922476603,42.76419077523397
44,PUNJAB,Faridkot,617508,381285,215767,165518,4348,99946,58917,158863,221555,185049,36506,61.745758759400694,2.7369494470077993,62.913327835934105,37.086672164065895,35.878887399029644,16.477172711064973,83.52282728893503,56.5894278558034,43.4105721441966
45,PUNJAB,Bathinda,1388525,844868,488261,356607,11284,218159,137563,355722,549986,432988,116998,60.84643776669487,3.1721400419428654,61.328509341564484,38.67149065843552,39.609369654849566,21.27290512849418,78.72709487150583,57.791394632060864,42.208605367939136
46,PUNJAB,Mansa,769751,423560,244037,179523,2673,145603,50786,196389,328512,230739,97773,55.025586196055606,1.3610741945831997,74.14009949640764,25.85990050359236,42.67769707346921,29.762383109292813,70.23761689070719,57.61568608933799,42.38431391066201
47,PUNJAB,Patiala,1895686,1266791,711052,555739,24274,299279,218090,517369,660267,549661,110606,66.82493830729351,4.691815706004805,57.84633404784593,42.15366595215407,34.829977116463375,16.75170802114902,83.24829197885097,56.13017459075728,43.86982540924272
48,PUNJAB,Amritsar,2490656,1684770,932981,751789,29961,275477,385476,660953,917856,735195,182661,67.6436248120977,4.533000077161311,41.678757793670655,58.32124220632935,36.851977952796375,19.90083411777011,80.0991658822299,55.37735121114454,44.62264878885545
49,PUNJAB,Tarn Taran,1119627,666162,376427,289735,4300,222717,44457,267174,380702,313639,67063,59.498565147142756,1.6094380441210598,83.36028206337444,16.63971793662557,34.00257407154347,17.615615363197463,82.38438463680254,56.506825667029936,43.49317433297006
50,PUNJAB,Rupnagar,684627,502731,278534,224197,6600,148162,60537,208699,233676,186910,46766,73.43137211941685,3.162449269042976,70.99315281817354,29.006847181826455,34.13187034691884,20.013180643283864,79.98681935671613,55.404182355971685,44.595817644028315
51,PUNJAB,Sahibzada Ajit Singh Nagar,994628,736575,409944,326631,25944,117293,174042,291335,355995,283367,72628,74.05532520701207,8.905212212744779,40.26052482537285,59.739475174627145,35.791773406741015,20.401410132164777,79.59858986783523,55.655432237043065,44.34456776295693
52,PUNJAB,Sangrur,1655169,1002077,570413,431664,10736,292156,156788,448944,568758,485129,83629,60.54227695177955,2.391389571973342,65.07626786414342,34.92373213585659,34.36253337272508,14.703793177414648,85.29620682258535,56.92307078198582,43.076929218014186
53,PUNJAB,Barnala,595527,359831,201999,157832,3501,102577,54222,156799,209331,178163,31168,60.42228144147956,2.2327948520079848,65.41942231774436,34.58057768225562,35.15054733034774,14.889337938480207,85.11066206151979,56.13718662372058,43.86281337627942
54,CHANDIGARH,Chandigarh,1055450,805438,465346,340092,44283,8911,289456,298367,404136,328159,75977,76.31228385996495,14.841788803721592,2.986590340084527,97.01340965991547,38.290397460798715,18.799859453253358,81.20014054674664,57.77552089670465,42.22447910329535
55,UTTARAKHAND,Uttarkashi,330086,215126,128237,86889,602,112148,9061,121209,157276,84265,73011,65.17271256581618,0.49666278906681843,92.52448250542452,7.475517494575485,47.646976848457676,46.42221317937892,53.57778682062108,59.610181939886395,40.389818060113605
56,UTTARAKHAND,Chamoli,391605,280556,155395,125161,899,163434,22906,186340,180940,93832,87108,71.6425990475096,0.48245143286465597,87.70741655039176,12.292583449608244,46.20472159446381,48.1419255001658,51.858074499834196,55.388229087953924,44.611770912046076
57,UTTARAKHAND,Rudraprayag,242285,170933,91803,79130,418,112705,4454,117159,113032,52339,60693,70.55038487731392,0.35678010225420154,96.19832876688945,3.8016712331105587,46.652496027405746,53.69541368815911,46.30458631184089,53.70700800898598,46.29299199101402
58,UTTARAKHAND,Tehri Garhwal,618931,407994,227406,180588,1366,227059,27177,254236,280442,140821,139621,65.91914122898999,0.5372960556333486,89.31032583898426,10.68967416101575,45.31070507051675,49.78605201788605,50.21394798211395,55.737584376240825,44.262415623759175
59,UTTARAKHAND,Dehradun,1696694,1259506,702216,557290,25862,228245,269393,497638,582768,458834,123934,74.23294948882946,5.196950393659648,45.86566942235118,54.13433057764882,34.347265918309375,21.266438788677483,78.73356121132251,55.75328739998062,44.24671260001937
60,UTTARAKHAND,Garhwal,687271,494889,262148,232741,2633,279682,36780,316462,274152,147373,126779,72.00783970224263,0.8320114263323874,88.37775151518981,11.622248484810182,39.889941522339804,46.24405439318334,53.75594560681666,52.971070280406316,47.028929719593684
61,UTTARAKHAND,Pithoragarh,483439,345550,189623,155927,1344,183687,26256,209943,216490,113539,102951,71.47747699296086,0.6401737614495363,87.49374830311083,12.506251696889157,44.78124437622947,47.55462146057555,52.44537853942446,54.875705397192874,45.12429460280712
62,UTTARAKHAND,Bageshwar,259898,179483,97546,81937,435,96031,3880,99911,123638,58708,64930,69.0590154599112,0.43538749487043465,96.11654372391428,3.8834562760857163,47.57173968249082,52.516216697131945,47.48378330286805,54.348322682371034,45.651677317628966
63,UTTARAKHAND,Almora,622506,436497,231604,204893,1830,260056,21082,281138,298211,142460,155751,70.11932415109253,0.6509258798170293,92.50119158562698,7.498808414373012,47.90491979193775,52.22845569076928,47.77154430923071,53.059700295763776,46.940299704236224
64,UTTARAKHAND,Champawat,259648,177726,102015,75711,548,85202,12839,98041,99566,60427,39139,68.44882302193739,0.5589498271131466,86.90445833885823,13.095541661141768,38.34653068770027,39.309603679971076,60.690396320028924,57.40015529522974,42.59984470477026
65,UTTARAKHAND,Nainital,954605,696500,385779,310721,7265,193086,105577,298663,376181,256935,119246,72.96211522043149,2.4325075419452693,64.65012405286225,35.34987594713775,39.40697985030457,31.69910229384259,68.3008977061574,55.388226848528355,44.611773151471645
66,UTTARAKHAND,Udham Singh Nagar,1648902,1037839,598525,439314,7883,269406,145253,414659,591458,444578,146880,62.94121785284996,1.9010801646654238,64.97049382745821,35.02950617254177,35.86980912146386,24.83354692979045,75.16645307020954,57.67031302543073,42.32968697456928
67,UTTARAKHAND,Hardwar,1890422,1178354,691411,486943,11947,301828,186183,488011,578121,497810,80311,62.3328547805728,2.4481005551104382,61.84860587158896,38.15139412841104,30.581584429296736,13.8917285481759,86.10827145182411,58.67600059065442,41.32399940934558
68,HARYANA,Panchkula,561293,405318,229862,175456,18615,70895,93656,164551,211479,164865,46614,72.2114831291322,11.312602171971,43.08390711694246,56.91609288305754,37.67711337928675,22.041904869987093,77.95809513001291,56.71152033711802,43.28847966288198
69,HARYANA,Ambala,1128350,818025,461288,356737,12899,175365,139891,315256,372139,320120,52019,72.49745203172775,4.091595401832162,55.62622122973075,44.37377877026924,32.98081269109762,13.978379046539063,86.02162095346094,56.3904526145289,43.6095473854711
70,HARYANA,Yamunanagar,1214205,832457,474793,357664,8079,214464,143259,357723,389233,342343,46890,68.55983956580644,2.258451371591986,59.95253310522387,40.04746689477612,32.05661317487574,12.04676890191736,87.95323109808264,57.03513815127989,42.96486184872011
71,HARYANA,Kurukshetra,964655,646893,370828,276065,7356,203553,88268,291821,336780,268556,68224,67.05951868802836,2.5207233201174692,69.75269086186395,30.247309138136046,34.9119633444081,20.257735019894294,79.7422649801057,57.32447251709324,42.67552748290676
72,HARYANA,Kaithal,1074304,646529,385782,260747,3724,231091,75696,306787,373899,292696,81203,60.18119638389133,1.213871513460479,75.32620352231353,24.673796477686473,34.803835785773856,21.71789707915774,78.28210292084225,59.669713191519634,40.330286808480366
73,HARYANA,Karnal,1505324,978013,564516,413497,11163,292682,135920,428602,516062,411646,104416,64.97026553751883,2.6045142113195925,68.28759548485542,31.712404515144588,34.2824534784538,20.233227790459285,79.76677220954072,57.72070514400115,42.27929485599884
74,HARYANA,Panipat,1205437,786599,464136,322463,10024,173502,153804,327306,412318,328667,83651,65.25426048810515,3.062577526840327,53.00911074040806,46.99088925959194,34.20485682785579,20.287981606429987,79.71201839357002,59.00541444878521,40.99458555121478
75,HARYANA,Sonipat,1450001,998316,589881,408435,9029,283858,133576,417434,523179,391085,132094,68.84933182804701,2.1629766621789313,68.00068992942597,31.999310070574033,36.08128546118244,25.248337567065953,74.75166243293404,59.08760352433497,40.91239647566502
76,HARYANA,Jind,1334152,832758,502049,330709,5263,278335,89665,368000,523422,368277,155145,62.41852502563427,1.4301630434782608,75.63451086956522,24.365489130434785,39.23256120741864,29.64051950433875,70.35948049566124,60.28750249172028,39.71249750827972
77,HARYANA,Fatehabad,942011,557578,327471,230107,3210,203020,55360,258380,369083,263498,105585,59.19017930788494,1.2423562195216347,78.5741930489976,21.4258069510024,39.18032804287848,28.607386414437947,71.39261358556206,58.730975755858374,41.269024244141626
78,HARYANA,Sirsa,1295189,782897,456968,325929,6287,245476,93316,338792,502003,369462,132541,60.446544867196984,1.8557108786512078,72.45625634607666,27.543743653923354,38.759053697954506,26.402431857976943,73.59756814202305,58.36885311860948,41.63114688139053
79,HARYANA,Hisar,1743931,1114311,670200,444111,10132,302013,154113,456126,691621,488321,203300,63.89650737328484,2.2213160398661773,66.21262545875481,33.78737454124518,39.65873649817567,29.394711843625338,70.60528815637466,60.14478902209527,39.85521097790473
80,HARYANA,Bhiwani,1634445,1069871,643158,426713,5292,357047,99235,456282,623006,430678,192328,65.45775477302693,1.1598090654463686,78.25138839577279,21.74861160422721,38.11728140133195,30.87097074506506,69.12902925493495,60.115471865299654,39.88452813470035
81,HARYANA,Rohtak,1061204,747582,436025,311557,8482,175203,131739,306942,345967,272646,73321,70.44658708410448,2.7633885229131234,57.080164982309356,42.91983501769064,32.60136599560499,21.193061766006586,78.80693823399342,58.324705517254294,41.675294482745706
82,HARYANA,Jhajjar,958405,676091,399480,276611,5034,211816,78328,290144,326534,250020,76514,70.5433506711672,1.7350005514503144,73.00374986213743,26.996250137862575,34.070565157736034,23.432169391242567,76.56783060875743,59.08672057459721,40.91327942540279
83,HARYANA,Mahendragarh,922088,630255,380440,249815,2624,223726,44216,267942,338584,232935,105649,68.35085154562255,0.9793164192250561,83.49792119189974,16.502078808100258,36.71927191330979,31.203187392198096,68.79681260780191,60.36286899746928,39.63713100253072
84,HARYANA,Rewari,900332,636947,375453,261494,5121,199449,69305,268754,337727,235326,102401,70.74579155244955,1.9054600117579645,74.21247683755404,25.787523162445954,37.51138468920354,30.320643596751225,69.67935640324879,58.94572075855605,41.05427924144395
85,HARYANA,Gurgaon,1514432,1111116,638666,472450,67087,141703,381988,523691,544716,432456,112260,73.3684972319655,12.810416829771754,27.058513512739385,72.94148648726062,35.96833664370536,20.608904456634285,79.39109554336572,57.47968708937681,42.52031291062319
86,HARYANA,Mewat,1089263,454897,308435,146462,935,187398,36237,223635,289964,224642,65322,41.76190690402593,0.41809198023565186,83.79636461197934,16.20363538802066,26.62020099828967,22.527624118856135,77.47237588114386,67.8032609579751,32.196739042024895
87,HARYANA,Faridabad,1809733,1272739,734940,537799,43437,87700,382981,470681,579229,476933,102296,70.32744609287668,9.228543323397375,18.63257705324838,81.36742294675162,32.006323584749794,17.66071795438419,82.33928204561582,57.7447536376272,42.25524636237281
88,HARYANA,Palwal,1042708,599796,379696,220100,4283,186069,63090,249159,309563,241464,68099,57.522911495835835,1.7189826576603693,74.67881954896272,25.32118045103729,29.688369131146974,21.99843004493431,78.00156995506569,63.304190091297706,36.695809908702294
89,NCT OF DELHI,North West,3656539,2707855,1541952,1165903,114044,67592,959275,1026867,1188545,1022419,166126,74.05513793234532,11.106014702975166,6.582351950155181,93.41764804984481,32.504644419217186,13.977257907777998,86.022742092222,56.94366943577111,43.05633056422889
90,NCT OF DELHI,North,887978,681517,381615,299902,21418,4512,296559,301071,296446,257575,38871,76.7493113568129,7.1139365797436485,1.4986498201420928,98.50135017985791,33.38438564919401,13.112337491482428,86.88766250851756,55.99493482921189,44.00506517078811
91,NCT OF DELHI,North East,2241624,1611588,912481,699107,30390,5326,482255,487581,661386,594353,67033,71.89376987398421,6.232810548401189,1.0923313254618208,98.90766867453817,29.50476975621246,10.135231166066411,89.86476883393358,56.61999220644483,43.38000779355517
92,NCT OF DELHI,East,1709346,1352998,748382,604616,80037,1086,461132,462218,579692,486951,92741,79.15296259505097,17.315855289062736,0.23495406929197912,99.76504593070801,33.91308722751275,15.998323247517648,84.00167675248235,55.31286816388494,44.68713183611506
93,NCT OF DELHI,New Delhi,142004,114179,65678,48501,7366,0,52664,52664,59541,46940,12601,80.40548153573138,13.986784140969164,0.0,100.0,41.92910058871581,21.1635679615727,78.8364320384273,57.52196113120627,42.47803886879374
94,NCT OF DELHI,Central,582320,442360,240518,201842,19724,0,194897,194897,207374,177621,29753,75.96510509685397,10.120217345572277,0.0,100.0,35.611691166369006,14.347507402085121,85.65249259791487,54.37155258160774,45.62844741839226
95,NCT OF DELHI,West,2543243,1961179,1093933,867246,109666,1809,699703,701512,874320,732598,141722,77.11331555812795,15.632804570698719,0.2578715688398773,99.74212843116013,34.37815419132187,16.20939701711044,83.79060298288957,55.77935517359711,44.220644826402896
96,NCT OF DELHI,South West,2292958,1787689,1025261,762428,94853,41179,606503,647682,795352,667977,127375,77.9643150899406,14.644995537933738,6.357904033152072,93.64209596684793,34.68672343758586,16.01492169504823,83.98507830495177,57.35119475479236,42.64880524520764
97,NCT OF DELHI,South,2731929,2078402,1185036,893366,111453,2918,728145,731063,924393,775592,148801,76.07818504800088,15.245334533412306,0.3991448069455027,99.6008551930545,33.836640703327205,16.097157810584893,83.90284218941511,57.01668878301695,42.98331121698305
98,RAJASTHAN,Ganganagar,1969168,1193343,710908,482435,6295,397697,164897,562594,912672,596320,316352,60.6013808877658,1.11892412645709,70.68987582519543,29.310124174804564,46.34810234576227,34.66217874548578,65.33782125451421,59.572813516315094,40.427186483684906
99,RAJASTHAN,Hanumangarh,1774692,1034136,624281,409855,3360,389059,108694,497753,835260,512802,322458,58.271294399253506,0.675033601002907,78.16306481327085,21.83693518672916,47.06506819211446,38.60570361324617,61.39429638675382,60.367398485305614,39.63260151469439
100,RAJASTHAN,Bikaner,2363937,1278801,782399,496402,7607,335754,196179,531933,986208,640572,345636,54.09623860534354,1.4300673205084098,63.119603408699966,36.88039659130003,41.718878294979945,35.04696777961647,64.95303222038353,61.182232419273994,38.817767580726006
101,RAJASTHAN,Churu,2039547,1149269,696729,452540,2577,344897,148996,493893,902829,541404,361425,56.34922852966859,0.5217729346234913,69.83233210432219,30.16766789567781,44.266153219317815,40.03249784842977,59.96750215157023,60.623665999866006,39.376334000134
102,RAJASTHAN,Jhunjhunun,2137045,1370360,815834,554526,4828,500452,150357,650809,894649,541392,353257,64.12405915645202,0.741845917926765,76.89690830950401,23.103091690495983,41.863835342727924,39.48554125696223,60.51445874303777,59.53428296214134,40.46571703785867
103,RAJASTHAN,Alwar,3674179,2182476,1359829,822647,9750,782294,212967,995261,1708542,994171,714371,59.40037216477477,0.9796425259303841,78.60189437745476,21.39810562254524,46.50132723528168,41.81173187431155,58.188268125688445,62.30671036015975,37.69328963984025
104,RAJASTHAN,Bharatpur,2548462,1480869,943910,536959,4179,479437,129697,609134,1071154,647198,423956,58.108341423179944,0.6860559417139742,78.70796901831125,21.292030981688757,42.03138991281801,39.57936953976739,60.4206304602326,63.74027682394594,36.25972317605406
105,RAJASTHAN,Dhaulpur,1206516,683098,435721,247377,1330,214670,58626,273296,523212,339110,184102,56.617400846735556,0.4866518353726363,78.54853345822845,21.45146654177156,43.36552519817391,35.18688409287249,64.81311590712751,63.786016062117,36.213983937883
106,RAJASTHAN,Karauli,1458248,805849,531904,273945,1059,305047,59308,364355,628726,371058,257668,55.26145072717398,0.29065060174829493,83.72246847168283,16.277531528317162,43.115162852957795,40.98255837996202,59.01744162003798,66.00541788846299,33.99458211153703
107,RAJASTHAN,Sawai Madhopur,1335551,741748,486184,255564,1887,282057,71264,353321,578068,343802,234266,55.53872521528568,0.5340752460227386,79.83023935741154,20.169760642588468,43.283109368343105,40.52568209968378,59.47431790031622,65.54571094226071,34.45428905773929
108,RAJASTHAN,Dausa,1634409,938051,596935,341116,1719,361084,59610,420694,684495,398151,286344,57.39389589753849,0.40861053402235353,85.8305561762231,14.169443823776904,41.88027598966966,41.83288409703504,58.16711590296496,63.63566586464915,36.36433413535085
109,RAJASTHAN,Jaipur,6626178,4300965,2554793,1746172,76565,754841,977838,1732679,2464893,1714947,749946,64.90868491610095,4.418879665535278,43.56496500505864,56.43503499494136,37.199317615675284,30.425093503044554,69.57490649695545,59.40046012929656,40.59953987070343
110,RAJASTHAN,Sikar,2677333,1652117,995275,656842,5647,527560,178274,705834,1006504,657854,348650,61.7075649536311,0.8000464698498513,74.74278654754517,25.257213452454824,37.593530576883786,34.63970336928616,65.36029663071383,60.24240413965839,39.75759586034161
111,RAJASTHAN,Nagaur,3307743,1758624,1102750,655874,4449,675712,166489,842201,1425882,857031,568851,53.16688751211929,0.5282586935897725,80.23167866103222,19.768321338967777,43.10739981915161,39.89467571650389,60.10532428349611,62.70527412340557,37.29472587659443
112,RAJASTHAN,Jodhpur,3687165,2031532,1265753,765779,19335,584215,307442,891657,1489741,965103,524638,55.09739867893083,2.16843472321756,65.52014956423827,34.47985043576173,40.40342648077859,35.21672559189819,64.7832744081018,62.30534394732645,37.69465605267355
113,RAJASTHAN,Jaisalmer,669919,308653,210415,98238,754,159117,30830,189947,288903,182565,106338,46.07318198170226,0.3969528342116485,83.76915665948923,16.230843340510773,43.1250643734541,36.80750978702194,63.19249021297806,68.17202489527074,31.827975104729262
114,RAJASTHAN,Barmer,2603751,1188322,783461,404861,2766,542825,55980,598805,1202482,696240,506242,45.63884949060029,0.4619199906480406,90.65138066649409,9.3486193335059,46.18268029469792,42.099757002599624,57.900242997400376,65.93002570010485,34.069974299895144
115,RAJASTHAN,Jalor,1828730,829582,543923,285659,1585,419216,48202,467418,896644,494906,401738,45.36383173021715,0.3390969111159604,89.68760295923563,10.312397040764369,49.030966845843835,44.804627031463994,55.195372968536006,65.565911507241,34.434088492759
116,RAJASTHAN,Sirohi,1036346,476806,309900,166906,2146,238535,69639,308174,419829,272196,147633,46.008379440843115,0.6963598486569276,77.4027010714726,22.59729892852739,40.51050517877234,35.165031477101394,64.8349685228986,64.9949874791844,35.00501252081559
117,RAJASTHAN,Pali,2037573,1085693,667381,418312,4043,512909,139808,652717,842327,523077,319250,53.28363695435697,0.6194108625943556,78.58060997338816,21.41939002661184,41.33972132532185,37.90095770407454,62.09904229592546,61.47050777706037,38.52949222293963
118,RAJASTHAN,Ajmer,2583052,1526673,926268,600405,13499,409335,274919,684254,1053722,686149,367573,59.10345591184382,1.9728054202094545,59.822083612225875,40.17791638777413,40.79368127316059,34.88329939016173,65.11670060983828,60.67232472179701,39.327675278202996
119,RAJASTHAN,Tonk,1421326,749659,478329,271330,1908,298911,81755,380666,649161,371848,277313,52.743635168849366,0.5012267972448288,78.52316729101102,21.476832708988983,45.67291388464012,42.718678417218534,57.281321582781466,63.80621055706661,36.19378944293339
120,RAJASTHAN,Bundi,1110906,585044,371705,213339,1392,239836,63452,303288,526091,314806,211285,52.66368171564471,0.4589696921737755,79.0786315317454,20.9213684682546,47.35693208966375,40.16130289246537,59.838697107534635,63.53453757324235,36.46546242675765
121,RAJASTHAN,Bhilwara,2408523,1256126,777582,478544,6207,530015,145865,675880,1148165,674589,473576,52.15337366510513,0.9183582884535716,78.4185062437119,21.581493756288097,47.67091698937482,41.24633654570554,58.75366345429446,61.90318487158135,38.09681512841865
122,RAJASTHAN,Rajsamand,1156597,619139,383334,235805,1989,304622,61054,365676,550831,319534,231297,53.53109164211908,0.5439241295573131,83.30379899145693,16.69620100854308,47.62514514562981,41.99055608707571,58.00944391292428,61.914045149796735,38.085954850203265
123,RAJASTHAN,Dungarpur,1388552,681591,415820,265771,1477,322816,31547,354363,641515,346624,294891,49.086458411352254,0.41680423746271483,91.09754686578452,8.90245313421548,46.200286341454984,45.967904102008525,54.032095897991475,61.00726095268276,38.99273904731723
124,RAJASTHAN,Banswara,1797485,829343,513854,315489,2324,390437,39407,429844,916574,482236,434338,46.13907765572453,0.5406612631559357,90.83225542289762,9.167744577102392,50.99202496821948,47.38711767953269,52.6128823204673,61.959165266964334,38.040834733035666
125,RAJASTHAN,Chittaurgarh,1544338,821825,514851,306974,4941,366780,88873,455653,802755,456632,346123,53.215358295917085,1.0843778050402388,80.49546475058872,19.504535249411283,51.98052498870066,43.116891205909646,56.883108794090354,62.6472789219116,37.3527210780884
126,RAJASTHAN,Kota,1951014,1298345,765396,532949,12843,203454,311735,515189,748811,534650,214161,66.5471903328218,2.4928715481114696,39.491138203649534,60.508861796350466,38.380606187346686,28.60014075647927,71.39985924352072,58.95166538939958,41.04833461060042
127,RAJASTHAN,Baran,1222755,693307,432607,260700,1363,249184,69804,318988,552583,329754,222829,56.70040196114512,0.42728880083263315,78.11704515530364,21.882954844696354,45.191636918270625,40.324982853254625,59.67501714674538,62.39761029385251,37.60238970614749
128,RAJASTHAN,Jhalawar,1411129,739792,466815,272977,1750,298624,63763,362387,685950,402825,283125,52.42554011716859,0.48290915512973703,82.4047220236929,17.5952779763071,48.610013684078496,41.27487426197245,58.72512573802755,63.100844561714645,36.899155438285355
129,RAJASTHAN,Udaipur,3068420,1582629,973444,609185,14211,665449,182769,848218,1365783,835839,529944,51.57797824287418,1.675394768797644,78.45259119707434,21.547408802925663,44.51095352005267,38.801478712211235,61.198521287788765,61.50803504801189,38.491964951988116
130,RAJASTHAN,Pratapgarh,867848,401515,250122,151393,716,209813,24269,234082,481294,251691,229603,46.26559028770015,0.305875718765219,89.63226561632248,10.367734383677513,55.45832910832311,47.705352653471685,52.29464734652832,62.294559356437496,37.705440643562504
131,UTTAR PRADESH,Saharanpur,3466382,2077108,1220114,856994,9699,605082,284156,889238,1037344,911136,126208,59.92149739988264,1.0907091239915523,68.04500032612192,31.95499967387808,29.925841987409353,12.166455871919055,87.83354412808094,58.740999505081106,41.259000494918894
132,UTTAR PRADESH,Muzaffarnagar,4143512,2417339,1448528,968811,10077,673746,296104,969850,1291644,1081569,210075,58.34034027173084,1.0390266536062278,69.46909315873589,30.53090684126411,31.172686358818318,16.26415637745385,83.73584362254614,59.92241882499724,40.07758117500276
133,UTTAR PRADESH,Bijnor,3682713,2135393,1241471,893922,7303,683875,224648,908523,1088036,921497,166539,57.984236078130444,0.8038321539465704,75.27327321377665,24.726726786223356,29.544414674724855,15.306386921020994,84.693613078979,58.13782287382229,41.86217712617771
134,UTTAR PRADESH,Moradabad,4772006,2263848,1357435,906413,11690,692398,355518,1047916,1417811,1193439,224372,47.44017505426439,1.1155474293741101,66.07380744258128,33.92619255741872,29.711006230922592,15.825240458707118,84.17475954129287,59.96140200225457,40.038597997745434
135,UTTAR PRADESH,Rampur,2335819,1043666,630408,413258,3847,396775,143217,539992,737261,609693,127568,44.68094488485623,0.7124179617475814,73.47794041393206,26.522059586067943,31.563276092882198,17.30296326538363,82.69703673461638,60.40323245176139,39.59676754823862
136,UTTAR PRADESH,Jyotiba Phule Nagar,1840221,983110,600541,382569,2825,335888,115486,451374,599089,459037,140052,53.42347468048675,0.6258667978217619,74.41456530504637,25.58543469495363,32.55527461103856,23.377494829649685,76.62250517035032,61.08583983480994,38.91416016519006
137,UTTAR PRADESH,Meerut,3443689,2141488,1254520,886968,23717,381520,422303,803823,1090539,898810,191729,62.18587102377712,2.950525177806557,47.46318530323218,52.53681469676782,31.667755131197968,17.58112272921922,82.41887727078078,58.58169646526154,41.41830353473846
138,UTTAR PRADESH,Baghpat,1303048,797970,489858,308112,2989,246055,69991,316046,416695,342604,74091,61.23872643218055,0.9457484037133834,77.85417312669675,22.145826873303253,31.978484292213334,17.780630917097636,82.21936908290236,61.38802210609421,38.61197789390579
139,UTTAR PRADESH,Ghaziabad,4681645,3123264,1811397,1311867,78116,355407,836316,1191723,1520538,1231615,288923,66.71296093573946,6.554878944184177,29.822953824001047,70.17704617599895,32.47871207663118,19.001366621551057,80.99863337844894,57.99692245035962,42.00307754964038
140,UTTAR PRADESH,Gautam Buddha Nagar,1648115,1122947,666065,456882,53181,170835,338935,509770,569109,443384,125725,68.13523328165813,10.432351844949682,33.512172156070385,66.48782784392961,34.53090348671057,22.091550124844275,77.90844987515572,59.314019272503515,40.68598072749649
141,UTTAR PRADESH,Bulandshahr,3499171,2031656,1253314,778342,7865,658449,221628,880077,1173260,897815,275445,58.0610664640282,0.8936718037171748,74.81720349469421,25.182796505305788,33.52965602424117,23.476893442203774,76.52310655779623,61.689282043810564,38.310717956189436
142,UTTAR PRADESH,Aligarh,3673889,2092567,1283380,809187,13634,582117,275942,858059,1174361,929337,245024,56.957817723943215,1.588935026612389,67.84113912912748,32.158860870872516,31.96506481279102,20.864453094065624,79.13554690593438,61.33041379320232,38.66958620679768
143,UTTAR PRADESH,Mahamaya Nagar,1564708,942572,579157,363415,3087,288150,84883,373033,484115,398126,85989,60.23948238265542,0.8275407269598132,77.2451767001847,22.754823299815296,30.939638577932755,17.76210197990147,82.23789802009853,61.44432467758432,38.55567532241569
144,UTTAR PRADESH,Mathura,2547184,1507746,943346,564400,8726,407488,177802,585290,840939,635142,205797,59.19266138606398,1.490884860496506,69.62155512651847,30.37844487348152,33.0144583194618,24.47228633705893,75.52771366294107,62.56663920846084,37.43336079153916
145,UTTAR PRADESH,Agra,4418797,2680510,1614594,1065916,27183,496971,406852,903823,1389844,1119701,270143,60.66153299189803,3.0075578957384352,54.98543409495,45.01456590504999,31.45299501199082,19.436929612244253,80.56307038775576,60.23458222502435,39.76541777497566
146,UTTAR PRADESH,Firozabad,2498156,1521806,912314,609492,5834,349747,185621,535368,761521,621840,139681,60.91717250644075,1.0897177268719833,65.32833490234754,34.67166509765246,30.48332450015131,18.342370072525902,81.65762992747409,59.94942850797014,40.05057149202986
147,UTTAR PRADESH,Mainpuri,1868529,1203885,712110,491775,2642,338475,72783,411258,560840,466067,94773,64.42955929503904,0.6424191140354717,82.3023503494157,17.697649650584303,30.01505462318219,16.898402396405395,83.10159760359461,59.150998641896855,40.849001358103145
148,UTTAR PRADESH,Budaun,3681896,1547477,986501,560976,3634,710956,156668,867624,1107343,939616,167727,42.02935118210835,0.41884502964417764,81.94286926133901,18.057130738660987,30.075347049454955,15.146797333798109,84.8532026662019,63.74899271523906,36.25100728476094
149,UTTAR PRADESH,Bareilly,4448359,2191759,1342697,849062,15164,631613,362798,994411,1401971,1153006,248965,49.271180675840235,1.5249227934928313,63.516292559112884,36.48370744088712,31.516588476784364,17.75821325833416,82.24178674166585,61.26116055642979,38.738839443570214
150,UTTAR PRADESH,Pilibhit,2031007,1061095,654290,406805,2870,371752,89638,461390,618605,534939,83666,52.24477315932441,0.6220334207503414,80.5721840525369,19.427815947463102,30.45804371919939,13.524947260368087,86.47505273963192,61.661773922221855,38.338226077778145
151,UTTAR PRADESH,Shahjahanpur,3006538,1490930,915142,575788,3889,520289,134714,655003,892214,783313,108901,49.589594410581206,0.5937377386057774,79.43307129891008,20.566928701089918,29.675793221306368,12.205704012714438,87.79429598728557,61.38061478406096,38.61938521593905
152,UTTAR PRADESH,Kheri,4021243,2034044,1237157,796887,3402,754938,107672,862610,1264718,1058483,206235,50.58246915195127,0.3943844842976548,87.51788177739651,12.482118222603495,31.450922015904037,16.3067972465008,83.6932027534992,60.82252891284554,39.17747108715446
153,UTTAR PRADESH,Sitapur,4483992,2283733,1397702,886031,3874,827583,111319,938902,1422602,1171252,251350,50.93080005495103,0.4126096227295288,88.14370402874847,11.856295971251525,31.726238583833332,17.668328879054016,82.33167112094598,61.20251360382321,38.79748639617679
154,UTTAR PRADESH,Hardoi,4092845,2221601,1374587,847014,3845,786613,121064,907677,1318946,1091952,226994,54.28011566526463,0.4236088388270277,86.66221574414688,13.337784255853128,32.22565232741528,17.21025728119271,82.78974271880729,61.87371179613261,38.12628820386739
155,UTTAR PRADESH,Unnao,3108367,1773584,1053063,720521,3476,596317,121039,717356,1124744,851014,273730,57.05838467594078,0.48455717941998117,83.12706661685412,16.872933383145885,36.18440164884005,24.337093596409495,75.6629064035905,59.37485904248121,40.62514095751879
156,UTTAR PRADESH,Lucknow,4589838,3127260,1742440,1384820,68506,344155,717566,1061721,1542806,1226399,316407,68.13443088841044,6.452354243723163,32.41482461023188,67.58517538976812,33.613517514125775,20.508540931264204,79.4914590687358,55.7177848979618,44.28221510203821
157,UTTAR PRADESH,Rae Bareli,3405559,1965843,1165965,799878,5184,705025,73393,778418,1204710,867393,337317,57.72453215463306,0.66596610047558,90.57151813036184,9.428481869638164,35.3748092457068,27.99985058644819,72.00014941355181,59.31119626541895,40.68880373458104
158,UTTAR PRADESH,Farrukhabad,1885204,1092677,654827,437850,2624,316647,94843,411490,592267,494545,97722,57.96067693469779,0.6376825682276605,76.95132323993292,23.048676760067075,31.416600007214075,16.499653028110632,83.50034697188937,59.928688898915226,40.07131110108477
159,UTTAR PRADESH,Kannauj,1656616,1017087,603596,413491,2488,299785,65985,365770,524676,430934,93742,61.3954591770211,0.6802088744292861,81.95997484758182,18.04002515241819,31.671552127952403,17.86664532015949,82.13335467984051,59.34556237568665,40.65443762431335
160,UTTAR PRADESH,Etawah,1581810,1062003,623583,438420,2964,265643,85483,351126,506072,413713,92359,67.13846795759288,0.8441414193195604,75.65460831724225,24.345391682757757,31.99322295345206,18.250169936293652,81.74983006370636,58.7176307411561,41.28236925884391
161,UTTAR PRADESH,Auraiya,1379545,930836,546198,384638,2404,255836,58438,314274,442023,364543,77480,67.47413096346983,0.7649376022197192,81.40539783755575,18.594602162444236,32.041216488044974,17.528499648208353,82.47150035179165,58.67822043840161,41.32177956159839
162,UTTAR PRADESH,Kanpur Dehat,1796184,1170243,692964,477279,2682,363933,41323,405256,628864,493991,134873,65.15162143744739,0.6618038967960992,89.80323548571766,10.19676451428233,35.011112447277114,21.447085538367595,78.55291446163241,59.21539372591846,40.78460627408154
163,UTTAR PRADESH,Kanpur Nagar,4581268,3243022,1829179,1413843,33966,364869,684906,1049775,1572232,1299871,272361,70.78874233072591,3.2355504751018076,34.75687647353004,65.24312352646996,34.31870827028674,17.323206753201816,82.67679324679818,56.403533494376546,43.59646650562346
164,UTTAR PRADESH,Jalaun,1689974,1075196,653430,421766,2217,304856,91565,396421,620764,470969,149795,63.622043889432625,0.5592539244893686,76.90208137308568,23.097918626914314,36.73216274333215,24.130748561450083,75.86925143854991,60.77310555470816,39.22689444529184
165,UTTAR PRADESH,Jhansi,1998603,1304513,783705,520808,8517,309592,195321,504913,814914,565357,249557,65.27124196251081,1.6868252550439382,61.3159098696211,38.6840901303789,40.77418076526454,30.6237222578088,69.3762777421912,60.07644231985423,39.92355768014577
166,UTTAR PRADESH,Lalitpur,1221592,641191,397586,243605,1079,258013,43819,301832,503351,326783,176568,52.48814661523651,0.3574836332794402,85.48232129131438,14.517678708685628,41.20451018015835,35.07850386708281,64.92149613291718,62.00742056579085,37.99257943420915
167,UTTAR PRADESH,Hamirpur,1104285,653299,408125,245174,1196,256081,55300,311381,443655,308527,135128,59.16036168199332,0.38409536869622746,82.24040644740688,17.759593552593124,40.17576984202448,30.457900846378376,69.54209915362162,62.47139518046101,37.528604819538984
168,UTTAR PRADESH,Mahoba,875958,488106,302283,185823,1316,198298,48525,246823,349676,237153,112523,55.72253464207188,0.5331755954671972,80.34016278871904,19.65983721128096,39.91926553556221,32.179217332616474,67.82078266738351,61.92978574326069,38.07021425673931
169,UTTAR PRADESH,Banda,1799410,1002937,630626,372311,1655,378056,67569,445625,701689,485314,216375,55.73699156945888,0.37138849929873774,84.8372510518934,15.162748948106591,38.995504081893515,30.83631067324698,69.16368932675302,62.877927526853625,37.12207247314637
170,UTTAR PRADESH,Chitrakoot,991730,531072,330339,200733,827,207237,23558,230795,394197,254977,139220,53.55005898782935,0.35832665352368986,89.79267315149808,10.207326848501918,39.74841942867514,35.317366697361976,64.68263330263802,62.20230025307303,37.79769974692697
171,UTTAR PRADESH,Fatehpur,2632733,1512166,911003,601163,3385,558807,77733,636540,1063929,713736,350193,57.437119525603244,0.5317811920696265,87.78819869921765,12.211801300782355,40.411579905748134,32.91507234035354,67.08492765964647,60.24490697449883,39.75509302550117
172,UTTAR PRADESH,Pratapgarh,3209141,1931559,1121381,810178,5149,711085,41701,752786,1066601,704569,362032,60.18928429757371,0.6839925290852912,94.4604442696862,5.539555730313794,33.23633956875064,33.94258959067167,66.05741040932833,58.05574667923682,41.944253320763174
173,UTTAR PRADESH,Kaushambi,1599596,813424,507279,306145,1503,349856,30764,380620,639086,402644,236442,50.851840089622634,0.3948820345751668,91.91739792969365,8.082602070306342,39.9529631231886,36.99689869595015,63.00310130404985,62.36341686500522,37.63658313499479
174,UTTAR PRADESH,Allahabad,5954391,3665727,2199340,1466387,24122,983266,265304,1248570,2111907,1426110,685797,61.56342437035123,1.9319701738789175,78.75137156907502,21.248628430924978,35.468060461598846,32.472878777332525,67.52712122266747,59.99737569109757,40.00262430890243
175,UTTAR PRADESH,Bara Banki,3260699,1692458,1010518,681940,3159,635840,79068,714908,1192850,871241,321609,51.90476029832867,0.44187503846648796,88.94011537148836,11.05988462851164,36.58264684964788,26.961394978413043,73.03860502158696,59.707124194514726,40.29287580548528
176,UTTAR PRADESH,Faizabad,2470996,1450901,838339,612562,4746,510378,79288,589666,831209,597888,233321,58.71725409510983,0.8048624136375507,86.5537439838824,13.4462560161176,33.638621835081885,28.070076238346793,71.9299237616532,57.780579102226824,42.219420897773176
177,UTTAR PRADESH,Ambedkar Nagar,2397888,1486939,846676,640263,2509,501559,65031,566590,787398,547406,239992,62.010360784156724,0.442824617448243,88.52238832312607,11.47761167687393,32.837146689086396,30.479122375215585,69.52087762478442,56.94086980030788,43.05913019969212
178,UTTAR PRADESH,Sultanpur,3797117,2239902,1300248,939654,5956,839737,49891,889628,1242632,869838,372794,58.9895439092343,0.6694933163074903,94.39192561385208,5.608074386147918,32.72567055479196,30.000354087131186,69.99964591286881,58.04932537227076,41.95067462772925
179,UTTAR PRADESH,Bahraich,3487731,1398368,878285,520083,2681,698520,61742,760262,1152160,895576,256584,40.09391779354543,0.35264158934683043,91.87885229039463,8.121147709605372,33.03465777607275,22.269823635606166,77.73017636439383,62.807858875489146,37.192141124510854
180,UTTAR PRADESH,Shrawasti,1117361,423313,276700,146613,624,248770,8504,257274,403755,293981,109774,37.885070268248136,0.2425429697520931,96.69457465581442,3.3054253441855765,36.13469594875783,27.18827011430199,72.811729885698,65.36534431968781,34.63465568031221
181,UTTAR PRADESH,Balrampur,2148665,868357,544943,323414,1551,410070,35768,445838,760253,534332,225921,40.413791819571685,0.3478842090624846,91.97735500338689,8.022644996613119,35.382574761537974,29.71655488370319,70.28344511629682,62.755640825144496,37.244359174855504
182,UTTAR PRADESH,Gonda,3433919,1679994,1034181,645813,4313,673578,52794,726372,1170552,855848,314704,48.92351858037421,0.593772887721443,92.73182336323536,7.2681766367646325,34.0879327671969,26.885093528523296,73.1149064714767,61.55861270933111,38.44138729066889
183,UTTAR PRADESH,Siddharthnagar,2559297,1228926,740718,488208,2434,480165,33348,513513,878898,583633,295265,48.018108097653375,0.47398994767415814,93.50590929538298,6.49409070461702,34.341383590884526,33.594910899785866,66.40508910021413,60.273604757324684,39.72639524267531
184,UTTAR PRADESH,Basti,2464464,1393783,819719,574064,3423,513960,31065,545025,783688,558642,225046,56.55521849781535,0.6280445851107748,94.30026145589652,5.699738544103481,31.799531257100938,28.7162748440706,71.2837251559294,58.812526770666594,41.187473229333406
185,UTTAR PRADESH,Sant Kabir Nagar,1715183,954949,567098,387851,2031,324972,27179,352151,539469,383482,155987,55.67621647369406,0.5767412274848006,92.28200402668175,7.717995973318264,31.452562204732672,28.914914480720853,71.08508551927915,59.38516088293721,40.61483911706279
186,UTTAR PRADESH,Mahrajganj,2684703,1419144,881674,537470,2694,573046,34033,607079,994253,659465,334788,52.86037226464156,0.44376432062383975,94.39397508396765,5.606024916032345,37.03400338882923,33.67231479311604,66.32768520688396,62.127169617741394,37.8728303822586
187,UTTAR PRADESH,Gorakhpur,4440895,2700328,1593890,1106438,14597,761958,189170,951128,1351629,1016876,334753,60.805941144746726,1.5347040566569379,80.1109840105643,19.889015989435702,30.435959418090274,24.766633447491877,75.23336655250812,59.025792422253886,40.974207577746114
188,UTTAR PRADESH,Kushinagar,3564544,1954820,1183722,771098,3486,742324,42775,785099,1116973,804857,312116,54.84067527291009,0.444020435639327,94.5516425317062,5.448357468293807,31.33564910406492,27.94302100408873,72.05697899591127,60.55401520344584,39.44598479655416
189,UTTAR PRADESH,Deoria,3100946,1875239,1079288,795951,4469,597778,67928,665706,876246,639073,237173,60.47312658782191,0.6713173683277603,89.79609617458757,10.20390382541242,28.257376942391126,27.066942388324737,72.93305761167525,57.554690362135176,42.445309637864824
190,UTTAR PRADESH,Azamgarh,4613913,2771917,1559414,1212503,6652,891024,80434,971458,1372032,941890,430142,60.077357332051996,0.6847439621682049,91.72028023856925,8.279719761430757,29.736841591941594,31.350726513667322,68.64927348633269,56.25760078674794,43.74239921325206
191,UTTAR PRADESH,Mau,2205968,1363044,773082,589962,2656,352207,99321,451528,696747,475413,221334,61.788928941852284,0.5882248719902199,78.00335748835067,21.996642511649334,31.584637673801254,31.76676756412299,68.23323243587701,56.71731800294047,43.28268199705953
192,UTTAR PRADESH,Ballia,3239774,1963590,1160960,802630,4672,564927,64454,629381,1019483,723060,296423,60.608857284489595,0.7423166571599715,89.7591443021,10.2408556979,31.467719661927035,29.075815879225058,70.92418412077495,59.124358954771616,40.875641045228384
193,UTTAR PRADESH,Jaunpur,4494204,2731677,1565394,1166283,8002,926088,80582,1006670,1437375,934157,503218,60.782220833767234,0.7948980301389731,91.99519206890044,8.004807931099565,31.982860591108015,35.00951387077137,64.99048612922863,57.30523777152277,42.69476222847723
194,UTTAR PRADESH,Ghazipur,3620268,2197549,1293553,903996,5309,700173,61467,761640,1204602,808700,395902,60.70127957377741,0.6970484743448347,91.92965180400189,8.07034819599811,33.273834975753175,32.86579301711271,67.13420698288729,58.863442862935024,41.136557137064976
195,UTTAR PRADESH,Chandauli,1952756,1174606,699454,475152,3492,344937,50822,395759,652543,462971,189572,60.15119144429719,0.8823551706973184,87.15834636735993,12.841653632640066,33.41651491532993,29.051265587095408,70.94873441290459,59.547967573807725,40.452032426192275
196,UTTAR PRADESH,Varanasi,3676841,2403903,1389116,1014787,19214,438935,316129,755064,1220708,921234,299474,65.37957447711229,2.5446849538582157,58.13215833359821,41.86784166640179,33.19991264240145,24.532812105761575,75.46718789423844,57.78585908000448,42.21414091999552
197,UTTAR PRADESH,Sant Ravidas Nagar (Bhadohi),1578213,910146,546782,363364,2896,293510,45997,339507,470608,343155,127453,57.669402038888286,0.8530015581416583,86.45182573555185,13.548174264448157,29.819042169846526,27.08262502974875,72.91737497025125,60.07629545149899,39.92370454850101
198,UTTAR PRADESH,Mirzapur,2496970,1428683,865837,562846,4447,465152,77963,543115,881996,613061,268935,57.216666599919094,0.8187952827670014,85.64521326054336,14.354786739456655,35.32265105307633,30.49163488269788,69.50836511730212,60.60385683878089,39.39614316121911
199,UTTAR PRADESH,Sonbhadra,1862559,985708,601988,383720,5149,337048,91040,428088,730399,463611,266788,52.92224300008751,1.2027900805441871,78.7333445459812,21.2666554540188,39.21481145026815,36.526336974722035,63.47366302527796,61.07163581912695,38.92836418087304
200,UTTAR PRADESH,Etah,1774480,1055202,647042,408160,2635,334246,67752,401998,545984,440244,105740,59.4654208556873,0.6554758978900392,83.1461848068896,16.853815193110414,30.768675893782966,19.366867893564645,80.63313210643535,61.319254512406154,38.680745487593846
201,UTTAR PRADESH,Kanshiram Nagar,1436719,724850,452803,272047,1623,271234,72490,343724,472765,375213,97552,50.45175848582778,0.4721811686120259,78.91040485971303,21.089595140286974,32.90587790653566,20.63435321988726,79.36564678011274,62.468510726357174,37.53148927364282
202,BIHAR,Pashchim Champaran,3935042,1759481,1091226,668255,3495,839514,96620,936134,1478947,999282,479665,44.713144103671574,0.3733439870787729,89.67882803102974,10.321171968970253,37.58402070422628,32.43287284804662,67.56712715195339,62.019766056013104,37.98023394398689
203,BIHAR,Purba Champaran,5099371,2276957,1407603,869354,7719,1142260,101565,1243825,1737539,1260774,476765,44.65172273207813,0.6205856933250257,91.8344622434828,8.165537756517196,34.07359456685932,27.43909633107516,72.56090366892484,61.81948100029996,38.180518999700034
204,BIHAR,Sheohar,656246,283698,171645,112053,478,158484,7516,166000,216372,166693,49679,43.23043492836528,0.28795180722891567,95.47228915662652,4.527710843373494,32.97117239571746,22.959994823729502,77.0400051762705,60.50271767865829,39.49728232134171
205,BIHAR,Sitamarhi,3423574,1436794,885188,551606,3460,807294,49670,856964,1114583,865929,248654,41.96766303284229,0.40375091602447716,94.2039572257411,5.796042774258895,32.55612409721537,22.30915059712915,77.69084940287085,61.60855348783472,38.39144651216528
206,BIHAR,Madhubani,4487379,2155338,1340085,815253,5319,1047552,41234,1088786,1636938,1105947,530991,48.03111125670464,0.48852575253539265,96.21284623424621,3.787153765753785,36.478710623729356,32.438064239451954,67.56193576054805,62.175166957572316,37.824833042427684
207,BIHAR,Supaul,2229076,1033283,647672,385611,1845,572287,27815,600102,877682,551718,325964,46.35476762568885,0.30744773388523955,95.36495462438053,4.635045375619478,39.37425193219074,37.139191643442615,62.860808356557385,62.68098865460866,37.31901134539134
208,BIHAR,Araria,2811569,1195768,727643,468125,2561,659061,44213,703274,1069893,708391,361502,42.530274021373835,0.36415394284446745,93.71326111871049,6.286738881289512,38.05323646689802,33.78861250611042,66.21138749388957,60.85151969278322,39.14848030721678
209,BIHAR,Kishanganj,1690400,745056,439921,305135,1093,401793,43357,445150,529064,421192,107872,44.07572172266919,0.24553521284960125,90.26013703246096,9.73986296753903,31.29815428300994,20.389215671449957,79.61078432855004,59.045360348752304,40.954639651247696
210,BIHAR,Purnia,3264619,1332326,805261,527065,4170,712847,85749,798596,1143318,803275,340043,40.81107167482637,0.5221664020355724,89.26253074145126,10.737469258548753,35.02148336452125,29.741769131597685,70.25823086840232,60.44023759950643,39.559762400493575
211,BIHAR,Katihar,3071029,1280190,762256,517934,2941,668232,69838,738070,1013566,760522,253044,41.68602771253544,0.3984716896771309,90.53775387158399,9.462246128416004,33.004116861156305,24.965715108833564,75.03428489116644,59.542411673267246,40.457588326732754
212,BIHAR,Madhepura,2001762,834577,517666,316911,1397,486278,24000,510278,777546,496046,281500,41.692119242946966,0.27377233586398003,95.29668141679633,4.703318583203665,38.84307924718323,36.20364582931428,63.79635417068572,62.02735038228947,37.97264961771053
213,BIHAR,Saharsa,1900661,804996,506374,298622,1668,432651,38046,470697,649898,456724,193174,42.35347597493714,0.3543680966736563,91.91709316184297,8.082906838157031,34.19326223876851,29.723741264013736,70.27625873598626,62.90391505050956,37.09608494949043
214,BIHAR,Darbhanga,3937385,1816634,1125566,691068,6280,907174,95539,1002713,1223640,947927,275713,46.138084032930486,0.6263008458053302,90.47194960073321,9.528050399266789,31.07747908827813,22.532199012781536,77.46780098721845,61.95887559079044,38.04112440920956
215,BIHAR,Muzaffarpur,4801062,2509232,1487117,1022115,10290,998694,120700,1119394,1547586,1195308,352278,52.264103233826184,0.9192473784922914,89.21738011817109,10.782619881828918,32.23424317369782,22.763064540516652,77.23693545948335,59.265823168204456,40.734176831795544
216,BIHAR,Gopalganj,2562012,1382998,793905,589093,3707,515925,38133,554058,728201,539586,188615,53.98093373489273,0.6690635276451201,93.11750755336084,6.88249244663916,28.42301285083754,25.901502469785125,74.09849753021487,57.40463832919498,42.59536167080502
217,BIHAR,Siwan,3330464,1930175,1115906,814269,3834,632514,41858,674372,932416,730396,202020,57.95513778260326,0.568528942482784,93.79304004318092,6.206959956819085,27.996579455595377,21.666294872674857,78.33370512732513,57.813721553745125,42.186278446254875
218,BIHAR,Saran,3951862,2157454,1285767,871687,4509,701323,76299,777622,1040231,857660,182571,54.59335371528662,0.5798447060396954,90.18816340072682,9.81183659927317,26.32255377338581,17.55100549781731,82.4489945021827,59.59649661128349,40.403503388716516
219,BIHAR,Vaishali,3495021,1926740,1152576,774164,4810,699317,51494,750811,1060344,858648,201696,55.12813799974307,0.6406405873115871,93.14154960436115,6.858450395638849,30.338701827542668,19.021751431610873,80.97824856838912,59.820006850950314,40.17999314904969
220,BIHAR,Samastipur,4261566,2142880,1293575,849305,5379,1012979,43486,1056465,1343400,1037576,305824,50.28386278659066,0.5091508000738311,95.88382009815753,4.1161799018424645,31.523623006190682,22.764924817626916,77.23507518237308,60.366189427312776,39.633810572687224
221,BIHAR,Begusarai,2970541,1548673,918507,630166,4644,594377,139248,733625,938182,715345,222837,52.13437552284247,0.6330209575736923,81.01918555120122,18.980814448798775,31.58286655528404,23.752001210852477,76.24799878914752,59.30929253625523,40.69070746374477
222,BIHAR,Khagaria,1666886,768028,461153,306875,1580,373696,21007,394703,560805,398216,162589,46.07561644887533,0.4003009858045163,94.67777037418008,5.32222962581992,33.64387246638342,28.992073893777693,71.00792610622231,60.04377444572333,39.956225554276664
223,BIHAR,Bhagalpur,3037766,1573066,937669,635397,6764,522527,130634,653161,983528,740056,243472,51.78364627163514,1.0355792829026842,79.9997244171039,20.0002755828961,32.376687341948,24.75496376310588,75.24503623689412,59.60773419551373,40.39226580448627
224,BIHAR,Banka,2034763,965321,590961,374360,1704,425604,18492,444096,771080,517817,253263,47.44144649770023,0.3837008214440121,95.83603545179422,4.163964548205793,37.895322452786885,32.84523006691913,67.15476993308087,61.21911778568994,38.78088221431006
225,BIHAR,Munger,1367765,801817,473741,328076,2653,222281,85782,308063,426658,327453,99205,58.62242417374329,0.8611874843781955,72.15439699022602,27.845603009773974,31.193808877987085,23.251644174022285,76.74835582597771,59.083431755625035,40.916568244374965
226,BIHAR,Lakhisarai,1000912,507270,305182,202088,1186,175882,31763,207645,326576,240494,86082,50.68077912943396,0.5711671362180645,84.70321943701991,15.296780562980086,32.627843406812985,26.358948606143745,73.64105139385624,60.16164961460366,39.83835038539634
227,BIHAR,Sheikhpura,636342,328676,196431,132245,631,108293,24345,132638,224655,151569,73086,51.65084184290837,0.47573093683559764,81.64553144649346,18.354468553506535,35.304128911811574,32.532549909861785,67.46745009013821,59.76432717934988,40.23567282065012
228,BIHAR,Nalanda,2877653,1519933,919558,600375,4156,514141,102522,616663,1045420,703405,342015,52.818494794195125,0.673949953215938,83.37471195774677,16.625288042253224,36.32891109525714,32.71555929674198,67.28444070325801,60.49990361417247,39.50009638582753
229,BIHAR,Patna,5838465,3459679,2028047,1431632,40692,657991,552103,1210094,1881886,1436411,445475,59.25665393215511,3.3627139709807663,54.37519729872224,45.62480270127775,32.23254742470838,23.671731443881296,76.3282685561187,58.619513544464674,41.380486455535326
230,BIHAR,Bhojpur,2728407,1599151,973486,625665,3661,434559,77368,511927,822493,640283,182210,58.61116028510409,0.7151410259665929,84.88690770363743,15.113092296362568,30.145539136939615,22.153380028766204,77.84661997123379,60.87517689073765,39.12482310926235
231,BIHAR,Buxar,1706352,989807,593544,396263,1784,299252,35405,334657,538322,402180,136142,58.00719898356259,0.5330831269030679,89.42051115022247,10.579488849777533,31.54812137237803,25.29006802619993,74.70993197380007,59.96562966315655,40.034370336843445
232,BIHAR,Kaimur (Bhabua),1626384,920276,549923,370353,2100,325143,15299,340442,511163,375959,135204,56.584176922547194,0.6168451601153795,95.5061361406642,4.4938638593358045,31.429416423181735,26.450271244201947,73.54972875579804,59.756312236763755,40.243687763236245
233,BIHAR,Rohtas,2959918,1799832,1061783,738049,4594,512383,95678,608061,924879,707939,216940,60.806819648382145,0.7555163051075467,84.2650655115194,15.734934488480596,31.246777782357483,23.456041276750796,76.5439587232492,58.99345049982443,41.00654950017557
234,BIHAR,Aurangabad,2540073,1466002,868733,597269,2362,428291,49006,477297,837770,599157,238613,57.71495543632014,0.4948700704173712,89.73259836118811,10.267401638811894,32.98212295473398,28.481922245962494,71.5180777540375,59.258650397475584,40.741349602524416
235,BIHAR,Gaya,4391418,2297613,1368803,928810,6856,696289,111282,807571,1664062,1076170,587892,52.32052608064184,0.8489656017860968,86.22015897054253,13.77984102945747,37.893500459304946,35.328731741966344,64.67126825803365,59.57500240466954,40.42499759533046
236,BIHAR,Nawada,2219146,1091012,659474,431538,1841,379551,45323,424874,817041,539439,277602,49.163597167559054,0.4333049327565348,89.33260213616272,10.667397863837278,36.81781189700903,33.97650791086371,66.02349208913628,60.44608125300181,39.5539187469982
237,BIHAR,Jamui,1760405,858588,534385,324203,1839,325909,30851,356760,727571,452288,275283,48.77218594584769,0.515472586612849,91.3524498262137,8.647550173786298,41.329750824384156,37.835895053541165,62.164104946458835,62.23998006028503,37.76001993971497
238,BIHAR,Jehanabad,1125313,618881,374412,244469,1106,186660,28132,214792,365378,266423,98955,54.99634323961422,0.5149167566762263,86.90267793958807,13.097322060411933,32.46901084409404,27.082911395869484,72.91708860413053,60.49822179061888,39.50177820938113
239,BIHAR,Arwal,700843,386351,235279,151072,413,134334,9960,144294,236354,167991,68363,55.126611808921545,0.28622118729815516,93.09742608840284,6.902573911597155,33.72424351816313,28.92398690100443,71.07601309899557,60.89773289055807,39.10226710944193
240,SIKKIM,North  District,43709,30450,18579,11871,116,11543,2066,13609,23359,15935,7424,69.66528632547073,0.8523771033874642,84.81886986553016,15.181130134469836,53.44208286622892,31.782182456440772,68.21781754355922,61.01477832512315,38.98522167487685
241,SIKKIM,West District,136435,93432,51988,41444,286,32091,1886,33977,70348,40772,29576,68.48096163008026,0.841745886923507,94.44918621420373,5.550813785796274,51.56154945578481,42.042417694888265,57.957582305111735,55.64260638753318,44.35739361246682
242,SIKKIM,South District,146850,106741,59357,47384,591,31135,8163,39298,74753,45300,29453,72.68709567585972,1.503893327904728,79.22795053183368,20.77204946816632,50.9043241402792,39.400425400987245,60.599574599012755,55.608435371600414,44.391564628399586
243,SIKKIM,East District,283583,214329,121345,92984,3291,40626,41512,82138,139678,92351,47327,75.57893103606351,4.00667169884828,49.46066376098761,50.539336239012385,49.254715550650076,33.88293074070362,66.11706925929639,56.61623018816866,43.38376981183134
244,ARUNACHAL PRADESH,Tawang,49977,26073,17720,8353,96,10730,2452,13182,28561,19554,9007,52.169998199171616,0.7282658170232135,81.39887725686542,18.601122743134578,57.14828821257778,31.53601064388502,68.46398935611498,67.9630268860507,32.036973113949294
245,ARUNACHAL PRADESH,West Kameng,83947,48492,29566,18926,202,17889,6306,24195,42493,28313,14180,57.76501840446948,0.834883240338913,73.93676379417235,26.06323620582765,50.61884284131655,33.370202150942504,66.6297978490575,60.97088179493525,39.029118205064755
246,ARUNACHAL PRADESH,East Kameng,78690,38449,21599,16850,57,14503,5215,19718,31710,16424,15286,48.861354682933026,0.28907597119383305,73.55208438989756,26.447915610102445,40.29736942432329,48.205613371176284,51.794386628823716,56.175713282530104,43.824286717469896
247,ARUNACHAL PRADESH,Papum Pare,176573,121048,65794,55254,2477,20308,30180,50488,65772,41263,24509,68.55408244748631,4.906116304864523,40.22341942639835,59.77658057360165,37.24918305743234,37.26357720610594,62.73642279389405,54.35364483510673,45.646355164893265
248,ARUNACHAL PRADESH,Upper Subansiri,83448,45278,24807,20471,139,14542,4672,19214,33370,17898,15472,54.25893969897421,0.7234308316852295,75.68439679400437,24.31560320599563,39.98897517016585,46.36499850164819,53.63500149835181,54.78819735854057,45.21180264145943
249,ARUNACHAL PRADESH,West Siang,112274,64746,36777,27969,303,22272,8503,30775,49177,29156,20021,57.66784829969539,0.9845653939886271,72.37043054427295,27.629569455727047,43.800879990024406,40.712121520222865,59.287878479777135,56.801964600129736,43.198035399870264
250,ARUNACHAL PRADESH,East Siang,99214,62576,34210,28366,450,19497,9524,29021,40222,23591,16631,63.07174390710988,1.55060128872196,67.18238516936012,32.81761483063988,40.54064950511017,41.348018497339766,58.651981502660234,54.66952186141651,45.33047813858348
251,ARUNACHAL PRADESH,Upper Siang,35320,18195,10723,7472,97,8569,2182,10751,17644,9968,7676,51.514722536806346,0.9022416519393546,79.70421356152916,20.295786438470838,49.954699886749715,43.50487417819089,56.49512582180911,58.93377301456444,41.06622698543556
252,ARUNACHAL PRADESH,Changlang,148226,73174,44027,29147,170,33422,6498,39920,62966,39329,23637,49.3665079000985,0.4258517034068136,83.72244488977955,16.27755511022044,42.4797269035122,37.539306927548196,62.460693072451804,60.16754584961872,39.83245415038129
253,ARUNACHAL PRADESH,Tirap,111975,47974,29313,18661,98,18420,6500,24920,50169,27545,22624,42.843491850859564,0.39325842696629215,73.91653290529695,26.08346709470305,44.80375083724046,45.09557694990931,54.90442305009069,61.101846833701586,38.898153166298414
254,ARUNACHAL PRADESH,Lower Subansiri,83030,54057,29470,24587,381,18112,5365,23477,30202,17339,12863,65.1053835962905,1.6228649316352175,77.14784682881117,22.852153171188824,36.374804287606885,42.58989470895967,57.410105291040324,54.51652884917772,45.48347115082228
255,ARUNACHAL PRADESH,Kurung Kumey,92076,36606,20258,16348,95,18603,1092,19695,38044,18429,19615,39.756288283591815,0.4823559279004823,94.45544554455445,5.544554455445545,41.318041617793995,51.55872148039112,48.44127851960887,55.34065453750752,44.65934546249249
256,ARUNACHAL PRADESH,Dibang Valley,8004,4436,2614,1822,17,2055,1175,3230,3555,2228,1327,55.42228885557221,0.5263157894736842,63.62229102167183,36.37770897832817,44.41529235382309,37.32770745428973,62.67229254571026,58.926961226330036,41.07303877366997
257,ARUNACHAL PRADESH,Lower Dibang Valley,54080,31849,18087,13762,207,12000,3950,15950,22326,14102,8224,58.89238165680474,1.297805642633229,75.23510971786834,24.76489028213166,41.283284023668635,36.835975992116815,63.16402400788319,56.78985211466608,43.210147885333924
258,ARUNACHAL PRADESH,Lohit,145726,83062,48380,34682,312,33599,11372,44971,60945,38910,22035,56.998751080795465,0.6937804362811589,74.71259255964955,25.287407440350446,41.82163786832823,36.15555008614324,63.844449913856764,58.245647829332306,41.754352170667694
259,ARUNACHAL PRADESH,Anjaw,21167,9990,6523,3467,27,6025,428,6453,10501,6224,4277,47.19610714791893,0.41841004184100417,93.36742600340926,6.632573996590733,49.61024235838806,40.72945433768213,59.27054566231787,65.29529529529529,34.7047047047047
260,NAGALAND,Mon,250260,119626,67432,52194,178,43607,7415,51022,147654,79425,68229,47.80068728522337,0.34886911528360315,85.46705342793305,14.532946572066951,59.00023975065931,46.2087041326344,53.7912958673656,56.36901676892984,43.63098323107017
261,NAGALAND,Mokokchung,194622,159494,83479,76015,537,37536,17742,55278,100067,57084,42983,81.95065306080505,0.9714533810919354,67.9040486269402,32.095951373059805,51.416078346743944,42.95422067214966,57.04577932785034,52.339899933539826,47.66010006646018
262,NAGALAND,Zunheboto,140757,102881,53504,49377,261,31267,6044,37311,79466,41178,38288,73.09121393607423,0.6995256090697113,83.80102382675351,16.198976173246496,56.456162038122436,48.18161226184783,51.81838773815216,52.00571534102507,47.994284658974934
263,NAGALAND,Wokha,166343,128208,67385,60823,198,38499,8170,46669,78412,42096,36316,77.07447863751405,0.42426450106066127,82.49373245623434,17.50626754376567,47.13874343976001,46.31433964189155,53.68566035810846,52.55912267565207,47.44087732434794
264,NAGALAND,Dimapur,378811,278037,150142,127895,3303,49116,62853,111969,151350,99645,51705,73.39728782955089,2.9499236395788118,43.86571283123008,56.13428716876992,39.95396121020773,34.1625371655104,65.83746283448959,54.00072652200966,45.999273477990336
265,NAGALAND,Phek,163418,105893,57926,47967,170,38903,7295,46198,80277,41556,38721,64.79885936677722,0.3679812978916836,84.20927312870687,15.79072687129313,49.123719541298996,48.23423894764378,51.76576105235622,54.702388259847204,45.297611740152796
266,NAGALAND,Tuensang,196596,117511,63653,53858,155,40690,9451,50141,98154,52931,45223,59.77283362835459,0.3091282583115614,81.15115374643506,18.848846253564947,49.92675334187878,46.07351712614871,53.9264828738513,54.16769493919718,45.83230506080282
267,NAGALAND,Longleng,50484,29859,16139,13720,37,12686,2451,15137,30568,16273,14295,59.14547183265986,0.24443416793287967,83.80788795666248,16.192112043337517,60.549877188812296,46.76459042135567,53.23540957864433,54.05070498007301,45.949295019926986
268,NAGALAND,Kiphire,74004,41232,22675,18557,47,16032,4290,20322,31959,16780,15179,55.71590724825685,0.23127644916838894,78.88987304399173,21.11012695600827,43.18550348629804,47.495228261209675,52.504771738790325,54.99369421808304,45.00630578191696
269,NAGALAND,Kohima,267988,197489,107038,90451,1928,31845,44255,76100,114825,68140,46685,73.69322506977925,2.533508541392904,41.846254927726676,58.153745072273324,42.847067779154294,40.65752231656869,59.342477683431305,54.19947440110589,45.80052559889411
270,NAGALAND,Peren,95219,62204,34584,27620,121,20204,4073,24277,61390,32249,29141,65.32729812327372,0.4984141368373357,83.22280347654159,16.777196523458418,64.47242672155767,47.46864310148233,52.53135689851768,55.5977107581506,44.402289241849395
271,MANIPUR,Senapati,479148,264477,148012,116465,256,38008,1826,39834,233622,124143,109479,55.19735029677678,0.6426670683335843,95.41597630165185,4.584023698348145,48.75779508627814,46.86159693864448,53.13840306135552,55.96403467976422,44.03596532023579
272,MANIPUR,Tamenglong,140651,85006,47403,37603,125,23982,4119,28101,70675,37237,33438,60.43753688206981,0.44482402761467565,85.34215864204121,14.657841357958793,50.24848739077575,47.31234524230633,52.68765475769367,55.764298990659476,44.23570100934052
273,MANIPUR,Churachandpur,274143,195935,104013,91922,837,52972,4853,57825,122655,70594,52061,71.4718230996232,1.4474708171206225,91.60743623000432,8.392563769995677,44.741248180694015,42.44506950389304,57.55493049610697,53.085462015464316,46.914537984535684
274,MANIPUR,Bishnupur,237399,156333,87313,69020,676,34977,21172,56149,109937,62807,47130,65.85242566312411,1.2039395180679975,62.29318420630822,37.70681579369178,46.30895665103897,42.87000736785613,57.12999263214387,55.85065213358664,44.149347866413365
275,MANIPUR,Thoubal,422168,269304,152617,116687,880,65961,38302,104263,195319,109377,85942,63.79071838699285,0.8440194508118892,63.264053403412525,36.735946596587475,46.265704648386425,44.00083965205638,55.99916034794362,56.67089980096842,43.32910019903158
276,MANIPUR,Imphal West,517992,392626,205985,186641,4913,51055,85746,136801,213387,128540,84847,75.79769571730837,3.591348016461868,37.32063362109926,62.67936637890074,41.19503776120095,39.76202861467662,60.23797138532338,52.463413019005365,47.53658698099464
277,MANIPUR,Imphal East,456113,324664,173314,151350,2739,64421,46520,110941,194848,117562,77286,71.18060656021645,2.468879855058094,58.06780180456279,41.932198195437216,42.71923843433535,39.66476432911808,60.335235670881914,53.38257398418057,46.61742601581943
278,MANIPUR,Ukhrul,183998,129829,70148,59681,276,36084,5806,41890,87929,46533,41396,70.56000608702269,0.6588684650274529,86.13989018858916,13.860109811410837,47.78801943499386,47.078893197921055,52.92110680207895,54.031071640388504,45.96892835961149
279,MANIPUR,Chandel,144182,90302,51053,39249,184,30377,3783,34160,76238,42615,33623,62.630564148090606,0.5386416861826698,88.92564402810305,11.074355971896956,52.87622588117795,44.10267845431412,55.89732154568588,56.53584638213993,43.46415361786007
280,MIZORAM,Mamit,86364,60191,32977,27214,90,16726,4129,20855,39339,24016,15323,69.69454865453199,0.4315511867657636,80.20139055382403,19.798609446175977,45.55022926219258,38.9511680520603,61.04883194793971,54.78726055390341,45.21273944609659
281,MIZORAM,Kolasib,83955,65895,34147,31748,367,9669,12507,22176,36672,22733,13939,78.48847596926926,1.65494227994228,43.601190476190474,56.398809523809526,43.68054314811506,38.00992582897033,61.99007417102966,51.82032020638895,48.179679793611044
282,MIZORAM,Aizawl,400309,340595,169547,171048,4019,20570,80341,100911,174636,104643,69993,85.08302336445097,3.982717444084391,20.384299035784007,79.61570096421599,43.62529945617011,40.07936507936508,59.92063492063492,49.77965031782616,50.22034968217385
283,MIZORAM,Champhai,125745,100802,51440,49362,186,18395,12717,31112,60342,34129,26213,80.16382361127678,0.5978400617125225,59.1250964258164,40.8749035741836,47.9875939401169,43.440721222365845,56.55927877763415,51.03073351719212,48.96926648280788
284,MIZORAM,Serchhip,64937,54476,27598,26878,131,7472,8018,15490,32397,18261,14136,83.89054006190617,0.8457069076823757,48.23757262750161,51.76242737249839,49.88989328118022,43.63366978423928,56.36633021576072,50.660841471473674,49.33915852852632
285,MIZORAM,Lunglei,161428,121122,64515,56607,482,21479,17315,38794,78292,46230,32062,75.03159303218773,1.2424601742537507,55.36680930040728,44.633190699592724,48.499640706692766,40.951821386603996,59.048178613396004,53.26447713875267,46.73552286124733
286,MIZORAM,Lawngtlai,117894,62861,36444,26417,162,21993,5273,27266,45566,28517,17049,53.31993146385736,0.5941465561505171,80.6608963544341,19.339103645565906,38.6499737051928,37.416055831102135,62.583944168897865,57.9755333195463,42.0244666804537
287,MIZORAM,Saiha,56574,42233,21861,20372,168,7043,5784,12827,19461,12211,7250,74.650899706579,1.3097372729398924,54.90761674592656,45.09238325407344,34.3991939760314,37.25399516982683,62.74600483017316,51.762839485710224,48.237160514289776
288,TRIPURA,West Tripura,1725739,1361354,722998,638356,6394,289621,217016,506637,698178,500406,197772,78.88527755355823,1.2620475804175377,57.165386657508236,42.834613342491764,40.45675504812721,28.32687366259034,71.67312633740966,53.10874320713055,46.89125679286945
289,TRIPURA,South Tripura,876001,646810,351082,295728,948,219171,44906,264077,366845,253229,113616,73.83667370242728,0.3589862047811812,82.99511127436317,17.004888725636842,41.8772352999597,30.971118592321005,69.028881407679,54.27900001546049,45.7209999845395
290,TRIPURA,Dhalai,378230,276217,151643,124574,273,89457,14071,103528,155831,105657,50174,73.0288448827433,0.26369677768333205,86.40850784328877,13.591492156711226,41.20006345345425,32.197701355956134,67.80229864404387,54.8999518494517,45.1000481505483
291,TRIPURA,North Tripura,693947,520402,275646,244756,997,150437,42184,192621,248667,186034,62633,74.99160598720074,0.5175967314051947,78.09999948084581,21.900000519154194,35.83371640773719,25.187499748659853,74.81250025134014,52.96789789432016,47.03210210567984
292,MEGHALAYA,West Garo Hills,643291,358702,193438,165264,1630,139351,18594,157945,255693,151914,103779,55.76045677617129,1.0320048118015765,88.22754756402546,11.772452435974548,39.74764142510932,40.587344980112874,59.412655019887126,53.927215348673826,46.072784651326174
293,MEGHALAYA,East Garo Hills,317917,192147,102513,89634,288,62698,11518,74216,126073,72262,53811,60.439359958731366,0.38805648377708307,84.48043548560958,15.519564514390428,39.65594793609653,42.682414156877364,57.31758584312263,53.35134038002155,46.64865961997845
294,MEGHALAYA,South Garo Hills,142334,82062,45003,37059,179,35930,3713,39643,53069,32826,20243,57.654530892126964,0.4515299043967409,90.63390762555811,9.366092374441894,37.28483707336265,38.14467956810944,61.85532043189056,54.840242743291654,45.159757256708346
295,MEGHALAYA,West Khasi Hills,383461,230678,117307,113371,149,74832,12299,87131,163345,89694,73651,60.15683472373984,0.17100687470590262,85.88447280531614,14.115527194683866,42.597552293453575,45.089228320426095,54.91077167957391,50.853137273602165,49.14686272639784
296,MEGHALAYA,Ribhoi,258840,155859,80977,74882,291,57988,5736,63724,106473,63871,42602,60.214418173388964,0.45665683259054674,90.99868181532861,9.001318184671396,41.13467779323134,40.012021827129885,59.987978172870115,51.95529292501556,48.04470707498444
297,MEGHALAYA,East Khasi Hills,825922,578030,287270,290760,5032,106248,108843,215091,326786,204303,122483,69.98602773627533,2.339474919917616,49.39676694980264,50.60323305019736,39.56620600976848,37.48110384165784,62.51889615834215,49.69811255471169,50.30188744528831
298,MEGHALAYA,Jaintia Hills,395124,187527,87371,100156,510,76546,7171,83717,154180,88839,65341,47.46029094663954,0.6091952649999403,91.43423677389299,8.565763226107004,39.02066186817303,42.379686081203786,57.62031391879622,46.59115753998091,53.40884246001909
299,ASSAM,Kokrajhar,887142,489305,275220,214085,1218,204896,17115,222011,341131,236322,104809,55.15520626912039,0.5486214647021994,92.29092252185703,7.709077478142976,38.452806878718405,30.72397407447579,69.27602592552421,56.2471260256895,43.7528739743105
300,ASSAM,Dhubri,1949258,922341,511551,410790,1828,460602,60417,521019,669819,524898,144921,47.31754339343483,0.35085092866095097,88.4040697172272,11.595930282772796,34.36276778138143,21.63584490735557,78.36415509264442,55.46224227265187,44.53775772734813
301,ASSAM,Goalpara,1008183,563577,304302,259275,1364,228610,39504,268114,362573,267118,95455,55.90026810608788,0.508738820054156,85.26596895350485,14.734031046495147,35.963014651109965,26.32711205743395,73.67288794256605,53.99475138268595,46.005248617314045
302,ASSAM,Barpeta,1693622,897058,499038,398020,2078,447189,52192,499381,561824,445297,116527,52.9668367557814,0.41611515055638876,89.54866124261837,10.451338757381638,33.17292760722286,20.740836988095914,79.25916301190409,55.63051664440872,44.36948335559128
303,ASSAM,Morigaon,957423,539902,289698,250204,1421,232206,25275,257481,351148,257984,93164,56.39116670478984,0.5518853818339994,90.18374171298076,9.816258287019236,36.676369796840056,26.531263171084557,73.46873682891545,53.6575156232057,46.34248437679431
304,ASSAM,Nagaon,2823768,1710716,921850,788866,5121,674999,124186,799185,979998,766728,213270,60.582739091880065,0.6407777923759831,84.46091956180358,15.539080438196413,34.705329899623486,21.76228931079451,78.23771068920549,53.8867935998728,46.1132064001272
305,ASSAM,Sonitpur,1924110,1108572,620525,488047,4358,483325,64528,547853,770606,537195,233411,57.614793333021495,0.7954688575219995,88.22165799949987,11.778342000500135,40.04999714153556,30.289278827312533,69.71072117268747,55.97516444579153,44.02483555420847
306,ASSAM,Lakhimpur,1042137,683486,375552,307934,1948,293239,34694,327933,429995,282250,147745,65.58504304136596,0.5940237792475902,89.42039989875981,10.579600101240192,41.26088988300003,34.359701856998335,65.64029814300166,54.94655340416629,45.05344659583371
307,ASSAM,Dhemaji,686133,423028,237761,185267,1192,211758,16504,228262,316800,186577,130223,61.65393589872517,0.5222069376418327,92.76971199761678,7.230288002383227,46.17180634075318,41.10574494949495,58.89425505050505,56.2045538356799,43.79544616432009
308,ASSAM,Tinsukia,1327929,798322,453449,344873,5135,290704,90910,381614,557196,366623,190573,60.11782256430879,1.3456005282825054,76.17749872908227,23.822501270917734,41.959773451743274,34.20214789768771,65.79785210231229,56.800263552802,43.199736447198
309,ASSAM,Dibrugarh,1326335,884531,491361,393170,8817,299852,77163,377015,560557,368013,192544,66.68986342062902,2.338633741363076,79.53317507260984,20.466824927390157,42.26360610253066,34.34869246124836,65.65130753875164,55.55045555215137,44.44954444784863
310,ASSAM,Sivasagar,1151050,813505,444767,368738,5146,360182,45047,405229,485717,325071,160646,70.67503583684463,1.269899242156904,88.88356953722463,11.11643046277537,42.197732505104035,33.073991645340804,66.92600835465919,54.67292764027265,45.32707235972735
311,ASSAM,Jorhat,1092256,794929,432335,362594,5651,286330,80824,367154,498618,320746,177872,72.7786343128351,1.539136166295342,77.98634905244121,22.01365094755879,45.65028711217883,35.673000172476726,64.32699982752328,54.38661817596289,45.61338182403711
312,ASSAM,Golaghat,1066888,721764,396475,325289,3073,292893,34190,327083,479928,309104,170824,67.6513373475004,0.9395168810363119,89.54699571668353,10.453004283316467,44.98391583746373,35.59367238419096,64.40632761580903,54.93139031594815,45.06860968405185
313,ASSAM,Karbi Anglong,956313,557214,314253,242961,1923,215691,37185,252876,383441,246193,137248,58.26690633715113,0.7604517629193756,85.2951644284155,14.704835571584493,40.095763625507544,35.793772705579215,64.20622729442078,56.39718312892354,43.60281687107646
314,ASSAM,Dima Hasao,214102,140873,78559,62314,524,37610,21309,58919,85028,56323,28705,65.79714341762337,0.8893565742799435,63.83339839440588,36.166601605594124,39.713781281818946,33.759467469539445,66.24053253046056,55.76583163558666,44.234168364413335
315,ASSAM,Cachar,1736617,1174128,639946,534182,5316,346227,88933,435160,608062,469752,138310,67.61007176596797,1.2216196341575514,79.56314918650611,20.436850813493887,35.01416835145573,22.74603576608964,77.25396423391035,54.50393824182712,45.49606175817287
316,ASSAM,Karimganj,1228686,795297,435942,359355,1933,261945,32695,294640,399171,319798,79373,64.72744053403392,0.6560548465924518,88.90340754819441,11.096592451805593,32.48763313002671,19.884460544478433,80.11553945552157,54.81499364388398,45.18500635611602
317,ASSAM,Hailakandi,659296,407366,226836,180530,1211,159215,16202,175417,214240,170792,43448,61.78802844245984,0.6903549826983701,90.76372301430307,9.23627698569694,32.495267679464156,20.280059746079164,79.71994025392084,55.68358674999877,44.31641325000123
318,ASSAM,Bongaigaon,738804,434078,237114,196964,2523,181923,38470,220393,255806,197542,58264,58.75414859692151,1.144773200600745,82.5448176666228,17.455182333377195,34.624338796216584,22.776635419028484,77.22336458097152,54.62474486152258,45.375255138477414
319,ASSAM,Chirang,482162,259902,145869,114033,747,129018,11613,140631,193894,128762,65132,53.90345983300219,0.5311773364336455,91.74221899865606,8.257781001343943,40.21345522874055,33.59155002217706,66.40844997782294,56.12461620149133,43.875383798508665
320,ASSAM,Kamrup,1517542,995319,550219,445100,3109,390596,43849,434445,628954,428492,200462,65.58757517090137,0.7156256833431159,89.90689270218326,10.093107297816754,41.44557448821845,31.872283187641703,68.1277168123583,55.280668810702906,44.7193311892971
321,ASSAM,Kamrup Metropolitan,1253938,1001191,537227,463964,29117,61334,366858,428192,490932,375613,115319,79.84374028061994,6.799986921754726,14.323948135415886,85.67605186458411,39.151218002803965,23.48981121621732,76.51018878378268,53.658792378277475,46.34120762172253
322,ASSAM,Nalbari,771639,531771,293184,238587,1631,210706,28238,238944,267623,210202,57421,68.91447943921963,0.6825867148788001,88.18216820677648,11.817831793223517,34.68240977970268,21.455928675786463,78.54407132421353,55.13350671623688,44.86649328376313
323,ASSAM,Baksa,950075,572837,322614,250223,1175,291641,3580,295221,406756,266611,140145,60.293871536457644,0.3980069168521209,98.78734913844205,1.2126508615579517,42.81304107570455,34.45431659274848,65.54568340725152,56.31863863542333,43.68136136457666
324,ASSAM,Darrang,928500,487039,268666,218373,1166,268517,20189,288706,324843,246864,77979,52.4543887991384,0.40387106606721024,93.00707293925308,6.9929270607469185,34.985783521809374,24.005134788189988,75.99486521181001,55.163138886208294,44.83686111379171
325,ASSAM,Udalguri,831668,469926,264326,205600,1448,267790,13835,281625,345030,230690,114340,56.50403766887748,0.5141588992454504,95.08743897026187,4.912561029738127,41.486506634859104,33.13914732052285,66.86085267947715,56.248430603967435,43.75156939603257
326,WEST BENGAL,Darjiling,1846823,1315585,717673,597912,10943,303284,215675,518959,683726,479586,204140,71.23503443481049,2.108644420850202,58.44084022051839,41.55915977948161,37.02173949533875,29.856989495792174,70.14301050420782,54.55162532257513,45.44837467742487
327,WEST BENGAL,Jalpaiguri,3872846,2498780,1396622,1102158,9322,798378,319426,1117804,1512910,1091361,421549,64.5205102397565,0.833956579149833,71.42379164862534,28.57620835137466,39.06455356086971,27.863455195616393,72.1365448043836,55.89215537182145,44.10784462817855
328,WEST BENGAL,Koch Bihar,2819086,1850504,1028733,821771,3534,803407,97331,900738,1127977,845308,282669,65.64198467162761,0.3923449438127402,89.19430511425077,10.805694885749242,40.01215287508079,25.05981948213483,74.94018051786517,55.59204411338749,44.40795588661251
329,WEST BENGAL,Uttar Dinajpur,3007134,1489667,853495,636172,2883,683981,94269,778250,1075626,799627,275999,49.53776585945289,0.37044651461612593,87.88705428846771,12.112945711532284,35.76914098274304,25.659383466000264,74.34061653399974,57.294348334225035,42.705651665774965
330,WEST BENGAL,Dakshin Dinajpur,1676276,1083685,596474,487211,2518,390949,70077,461026,702987,499560,203427,64.64836339600399,0.5461731008663285,84.79977268093339,15.200227319066602,41.93742557908125,28.937519470488077,71.06248052951193,55.04127121811228,44.95872878188772
331,WEST BENGAL,Maldah,3988845,2086432,1152019,934413,5357,830318,128678,958996,1537847,1086461,451386,52.30667022659442,0.5586050411054895,86.5820086840821,13.417991315917899,38.55369160747033,29.35181458233491,70.64818541766509,55.214787733316975,44.785212266683025
332,WEST BENGAL,Murshidabad,7103807,4055834,2177187,1878647,7951,1501066,350899,1851965,2589907,1985667,604240,57.09380899565543,0.4293277680733707,81.05261168542603,18.947388314573978,36.458014695500594,23.33056746825272,76.66943253174729,53.68037745134539,46.31962254865461
333,WEST BENGAL,Birbhum,3502404,2158447,1201481,956966,5210,831044,134565,965609,1331603,1029770,301833,61.62758493880204,0.5395558657800414,86.06423510965618,13.935764890343814,38.01968590716548,22.666890957740407,77.3331090422596,55.66414185754851,44.33585814245149
334,WEST BENGAL,Barddhaman,7717563,5247208,2918040,2329168,32323,1364868,862368,2227236,2911251,2293083,618168,67.99047834141425,1.4512606656860791,61.28079826295911,38.71920173704089,37.72241315036884,21.23375827092889,78.76624172907111,55.611288898781986,44.38871110121802
335,WEST BENGAL,Nadia,5167600,3480555,1878866,1601689,12787,1081381,468390,1549771,1842607,1554090,288517,67.35341357690223,0.8250896422761814,69.7768250922233,30.223174907776695,35.656920040250796,15.658086613151909,84.34191338684809,53.98179313356635,46.01820686643366
336,WEST BENGAL,North Twenty Four Parganas,10009781,7608693,4056046,3552647,105185,1209337,1649803,2859140,3571624,2945189,626435,76.0125820934544,3.6789034464909025,42.2972292367635,57.7027707632365,35.68134008126651,17.539220253867708,82.46077974613229,53.30805172452089,46.69194827547911
337,WEST BENGAL,Hugli,5519145,4078388,2211777,1866611,31725,992085,647953,1640038,2152870,1713608,439262,73.89528631699294,1.9344063979005364,60.49158617056434,39.50841382943565,39.00731000906843,20.40355432515665,79.59644567484335,54.23164740578876,45.768352594211244
338,WEST BENGAL,Bankura,3596674,2232992,1299337,933655,4273,900515,90885,991400,1466220,1050822,415398,62.08491511880143,0.4310066572523704,90.83266088359895,9.167339116401049,40.76599658462235,28.33121905307526,71.66878094692476,58.18816189220561,41.81183810779439
339,WEST BENGAL,Puruliya,2930115,1624905,1002058,622847,3551,653219,99433,752652,1249642,801254,448388,55.455331957960695,0.47179838756822545,86.78898083045019,13.211019169549806,42.648223704530366,35.88131640901954,64.11868359098045,61.66871294014111,38.33128705985888
340,WEST BENGAL,Haora,4850029,3605206,1942824,1662382,30751,483384,869313,1352697,1819845,1498170,321675,74.33369986035136,2.2733102830863086,35.73483196902188,64.26516803097812,37.522352959126636,17.6759559193228,82.32404408067721,53.88940326849562,46.11059673150438
341,WEST BENGAL,Kolkata,4496694,3588137,1926915,1661222,136618,0,1308106,1308106,1795740,1412466,383274,79.79500050481532,10.443954847695828,0.0,100.0,39.934672005700186,21.34351298072104,78.65648701927897,53.70238092915627,46.29761907084372
342,WEST BENGAL,South Twenty Four Parganas,8161961,5531657,3043277,2488380,20665,1568802,611430,2180232,2964494,2356571,607923,67.77362695068011,0.9478349093124036,71.95573682066862,28.044263179331374,36.320854755370675,20.5068048712529,79.49319512874709,55.01564901800672,44.98435098199328
343,WEST BENGAL,Paschim Medinipur,5913457,4078412,2266913,1811499,8970,1364335,201048,1565383,2509159,1757358,751801,68.96832089926417,0.5730227043477538,87.15662556703376,12.843374432966245,42.4313392318571,29.962270226797106,70.0377297732029,55.58322700109749,44.416772998902516
344,WEST BENGAL,Purba Medinipur,5095875,3923194,2149073,1774121,9076,1193006,170707,1363713,1910320,1516096,394224,76.98764196531508,0.6655359302140552,87.48219016757925,12.51780983242075,37.48757573527608,20.63654256878429,79.3634574312157,54.77865738987162,45.22134261012838
345,JHARKHAND,Garhwa,1322784,653476,405161,248315,565,272872,19180,292052,571431,335451,235980,49.4015651837337,0.19345869913577035,93.43267637270075,6.567323627299249,43.199116409028235,41.29632449062092,58.70367550937908,62.0008998035123,37.9991001964877
346,JHARKHAND,Chatra,1042886,510061,303902,206159,590,200974,14528,215502,397690,251213,146477,48.908605542695945,0.2737793616764577,93.25853124332953,6.741468756670471,38.133602330456064,36.8319545374538,63.16804546254621,59.58150103615058,40.41849896384942
347,JHARKHAND,Kodarma,716259,390249,238780,151469,845,116714,34771,151485,257418,173993,83425,54.48434155801184,0.5578110043898736,77.0465722678813,22.95342773211869,35.93923427140183,32.40837859046376,67.59162140953624,61.186575750354265,38.81342424964574
348,JHARKHAND,Giridih,2445474,1253475,783736,469739,1944,452564,46886,499450,1036277,623946,412331,51.256934238515726,0.38922815096606267,90.6124737210932,9.387526278906797,42.375302293134176,39.789650836600636,60.21034916339936,62.52506033227627,37.47493966772373
349,JHARKHAND,Deoghar,1492073,793538,489837,303701,1944,257373,64337,321710,551467,383691,167776,53.18359088328788,0.6042709272326008,80.00155419477169,19.99844580522831,36.95978682008186,30.423579289422577,69.57642071057742,61.728234816732154,38.271765183267846
350,JHARKHAND,Godda,1313551,604519,376212,228307,874,276454,15576,292030,552191,344019,208172,46.02173802159185,0.2992843201040989,94.66630140738965,5.333698592610348,42.03803278289156,37.69927434528994,62.30072565471006,62.233279681862776,37.76672031813723
351,JHARKHAND,Sahibganj,1150567,483263,287303,195960,591,223450,37543,260993,490202,295690,194512,42.00216067382429,0.22644285478920892,85.6153230163261,14.384676983673891,42.60525462663191,39.679968665978514,60.320031334021486,59.45065109474551,40.54934890525449
352,JHARKHAND,Pakur,900422,352881,206989,145892,328,200588,16587,217175,404584,234012,170572,39.19062395188034,0.15103027512374814,92.36238056866583,7.637619431334178,44.93270932962544,42.15984814031202,57.84015185968797,58.65688433211196,41.34311566788804
353,JHARKHAND,Dhanbad,2684487,1722204,1014950,707254,11568,258764,405455,664219,844504,658851,185653,64.15393332133849,1.741594263337845,38.957632949373625,61.04236705062638,31.458673482121537,21.98367325672821,78.01632674327179,58.93320419648311,41.06679580351689
354,JHARKHAND,Bokaro,2062330,1273520,759088,514432,9754,250312,258452,508764,685368,507677,177691,61.75151406418953,1.91719539904553,49.200022014136216,50.79997798586378,33.232702816717016,25.926363646975055,74.07363635302494,59.60550285821974,40.39449714178026
355,JHARKHAND,Lohardaga,461790,259707,149568,110139,351,96759,14725,111484,221332,121605,99727,56.239199636198265,0.31484338559793335,86.7918266298303,13.20817337016971,47.92914528248771,45.05765094970452,54.94234905029548,57.59105453453315,42.40894546546685
356,JHARKHAND,Purbi Singhbhum,2293919,1507699,856526,651173,22042,262537,342126,604663,837167,616249,220918,65.72590400968822,3.645336327838813,43.418730764078504,56.581269235921496,36.49505496924695,26.388761143236657,73.61123885676335,56.81014579169981,43.1898542083002
357,JHARKHAND,Palamu,1939869,1024563,621706,402857,2155,355529,52375,407904,713175,473042,240133,52.81609222066026,0.5283105828822467,87.15996901231662,12.840030987683376,36.7640804611033,33.670978371367475,66.32902162863252,60.68011435119168,39.319885648808324
358,JHARKHAND,Latehar,726978,350682,209706,140976,340,146377,14137,160514,313379,180106,133273,48.23832358063105,0.21181952976064394,91.19266855227582,8.807331447724186,43.10708164483657,42.52773797861376,57.47226202138624,59.799476448748436,40.20052355125156
359,JHARKHAND,Hazaribagh,1734495,1013249,596113,417136,3532,312983,68765,381748,654636,423472,231164,58.41752210297522,0.9252176828693275,81.98680805138468,18.01319194861532,37.74216702844343,35.31183741804606,64.68816258195395,58.831836991697,41.168163008303
360,JHARKHAND,Ramgarh,949443,596497,350031,246466,2876,134067,118558,252625,312125,234202,77923,62.82599376687173,1.138446313706086,53.069569520039586,46.930430479960414,32.8745380186067,24.96531838205847,75.03468161794153,58.68109982112232,41.31890017887768
361,JHARKHAND,Dumka,1321442,672409,406275,266134,1193,303697,23281,326978,624779,367108,257671,50.88448830898366,0.3648563511918233,92.87994910972603,7.120050890273963,47.280092505005896,41.241943151098226,58.758056848901774,60.42081530735014,39.57918469264986
362,JHARKHAND,Jamtara,791042,426312,258260,168052,808,165555,20113,185668,326631,214740,111891,53.89246083014555,0.43518538466510115,89.1672232156322,10.832776784367796,41.291233588102784,34.2560871442086,65.7439128557914,60.58004466212539,39.419955337874605
363,JHARKHAND,Ranchi,2914253,1911433,1085244,826189,22538,420740,310242,730982,1142867,743967,398900,65.58912352496506,3.0832496559422804,57.558188847331394,42.4418111526686,39.21646473384431,34.903448957752744,65.09655104224727,56.77646038338775,43.22353961661225
364,JHARKHAND,Khunti,531885,284575,164741,119834,417,123245,12474,135719,259984,141123,118861,53.50310687460635,0.30725248491368196,90.80895084697059,9.191049153029422,48.879739041334126,45.7185826820112,54.2814173179888,57.890187121145566,42.10981287885443
365,JHARKHAND,Gumla,1025213,559720,321795,237925,831,216629,16445,233074,487508,264774,222734,54.5954840603855,0.35653912491311773,92.9443009516291,7.0556990483709034,47.55187458606163,45.68827588470343,54.31172411529657,57.49213892660616,42.50786107339384
366,JHARKHAND,Simdega,599578,343483,191991,151492,423,144169,11114,155283,288645,159867,128778,57.28745884605506,0.27240586541991074,92.84274518137852,7.157254818621485,48.14135942279403,44.61466507301356,55.38533492698644,55.895342709828434,44.104657290171566
367,JHARKHAND,Pashchimi Singhbhum,1502338,727561,439273,288288,1959,336928,63396,400324,694863,392690,302173,48.42858264917748,0.4893536235649124,84.16382729988709,15.836172700112908,46.25210838040441,43.486701695154295,56.513298304845705,60.37610592101556,39.62389407898444
368,JHARKHAND,Saraikela-Kharsawan,1065056,612993,365332,247661,2606,217248,68439,285687,430051,283281,146770,57.5550018027221,0.9121871138693746,76.04406220794085,23.955937792059142,40.37825241114083,34.12851033947136,65.87148966052864,59.5980704510492,40.401929548950804
369,ORISSA,Bargarh,1481255,983783,557217,426566,2401,411566,47395,458961,762092,473305,288787,66.41550577044467,0.5231381315623768,89.67341451670185,10.326585483298146,51.44907527738303,37.893981304094524,62.10601869590548,56.640234685901255,43.359765314098745
370,ORISSA,Jharsuguda,579505,405879,228092,177787,2498,103224,73962,177186,247707,172018,75689,70.03891252016807,1.4098179314392785,58.25742440147641,41.74257559852359,42.74458373957084,30.555858332626855,69.44414166737315,56.19704394659492,43.802956053405076
371,ORISSA,Sambalpur,1041099,703691,393192,310499,5231,220697,94798,315495,505840,313161,192679,67.59117048426711,1.6580294457915339,69.9526141460245,30.0473858539755,48.58711803584481,38.0908983077653,61.9091016922347,55.875661334307246,44.124338665692754
372,ORISSA,Debagarh,312520,197819,112649,85170,825,91408,7350,98758,165435,92384,73051,63.29802892614873,0.8353753619959902,92.55756495676299,7.442435043237004,52.93581210802508,44.15691963611086,55.84308036388914,56.9454905747173,43.0545094252827
373,ORISSA,Sundargarh,2093437,1342322,750147,592175,12787,387911,230151,618062,873227,584687,288540,64.12048702683673,2.0688862929609004,62.7624736676903,37.237526332309706,41.7125999015017,33.04295446659345,66.95704553340654,55.88428111883735,44.11571888116264
374,ORISSA,Kendujhar,1801733,1052518,605119,447399,2622,490634,83664,574298,766514,498077,268437,58.41697965236803,0.4565573970308098,85.43195344577205,14.568046554227946,42.54315151024042,35.02049538560287,64.97950461439713,57.49250844166085,42.50749155833915
375,ORISSA,Mayurbhanj,2519738,1369397,794171,575226,2950,689110,64479,753589,1223534,697782,525752,54.34680113567363,0.3914600664287828,91.44374453448764,8.556255465512368,48.55798499685285,42.96995424728696,57.03004575271304,57.99421205099763,42.00578794900237
376,ORISSA,Baleshwar,2320529,1621232,902359,718873,7370,601154,82440,683594,932707,684020,248687,69.8647592854905,1.078125319999883,87.94021012472315,12.059789875276845,40.193723069179484,26.662928443766372,73.33707155623364,55.65884463173685,44.341155368263145
377,ORISSA,Bhadrak,1506337,1094140,596269,497871,2637,373862,54244,428106,468599,409559,59040,72.635804604149,0.6159689422713066,87.32930629330119,12.670693706698808,31.108510247042993,12.599258641183614,87.40074135881639,54.49659092986272,45.50340907013728
378,ORISSA,Kendrapara,1440361,1089265,579970,509295,1628,414749,23494,438243,466890,386382,80508,75.62444414976524,0.3714834007616779,94.63904728655108,5.360952713448931,32.414790458780814,17.243462057443935,82.75653794255606,53.2441600528797,46.7558399471203
379,ORISSA,Jagatsinghapur,1136971,889027,481049,407978,3199,309685,43047,352732,403649,325589,78060,78.19258362790255,0.9069208350815917,87.79611716544005,12.20388283455995,35.50213681791356,19.33858376956217,80.66141623043784,54.10960522008893,45.89039477991107
380,ORISSA,Cuttack,2624470,2011469,1103033,908436,15046,579529,210768,790297,936365,761876,174489,76.64286503560719,1.9038412141258287,73.33053269846653,26.669467301533473,35.67825122786696,18.634720434873152,81.36527956512684,54.83718615598848,45.16281384401152
381,ORISSA,Jajapur,1827192,1290455,706396,584059,3831,495611,45528,541139,552234,486091,66143,70.62503557371092,0.7079511918379566,91.58663485721783,8.413365142782169,30.223096423364375,11.97735018126374,88.02264981873627,54.7400723000802,45.25992769991979
382,ORISSA,Dhenkanal,1192811,829910,464093,365817,1810,315390,36979,352369,435533,340552,94981,69.57598479557952,0.5136660716464843,89.50560350087551,10.494396499124498,36.51316092826106,21.807991587319446,78.19200841268056,55.920882987311884,44.07911701268812
383,ORISSA,Anugul,1273821,869456,494425,375031,5564,340410,74177,414587,526520,360947,165573,68.25574393890508,1.34205848229684,82.10821854037874,17.89178145962126,41.33390798236173,31.44666869254729,68.55333130745271,56.86601737178189,43.13398262821811
384,ORISSA,Nayagarh,962789,688362,392333,296029,1163,261646,26688,288334,343633,284591,59042,71.49666230087797,0.40335166855105536,90.74406764377423,9.255932356225765,35.69141317568024,17.181702572220946,82.81829742777906,56.99515661817473,43.00484338182526
385,ORISSA,Khordha,2251673,1749936,957515,792421,35701,331834,356895,688729,792193,645880,146313,77.7171463174271,5.183606324112968,48.180634182675625,51.81936581732438,35.18241769564231,18.469362895153075,81.53063710484693,54.71714394126413,45.28285605873586
386,ORISSA,Puri,1698730,1291939,704857,587082,3416,402014,72210,474224,621676,498461,123215,76.05322799974098,0.7203346941529741,84.77301865784945,15.226981342150545,36.596516220941524,19.819809675779666,80.18019032422033,54.55807124020562,45.441928759794386
387,ORISSA,Ganjam,3529031,2210050,1262652,947398,9049,795476,219918,1015394,1501772,990027,511745,62.62483950976912,0.8911811572650616,78.34160926694466,21.658390733055345,42.55479762008324,34.076078126373375,65.92392187362663,57.13228207506618,42.86771792493382
388,ORISSA,Gajapati,577817,262537,153663,108874,635,152095,23050,175145,293933,155907,138026,45.436011747664054,0.36255673870221816,86.83947586285649,13.16052413714351,50.86956596984859,46.9583204335682,53.04167956643181,58.530035766387215,41.469964233612785
389,ORISSA,Kandhamal,733110,399786,233900,165886,768,218446,24489,242935,355349,193515,161834,54.53288046814257,0.3161339452940087,89.91952579908205,10.08047420091794,48.471443575998144,45.542269712311,54.457730287688996,58.506300870965966,41.493699129034034
390,ORISSA,Baudh,441162,271612,158648,112964,245,131377,6577,137954,219457,125627,93830,61.56740607758601,0.1775954303608449,95.23246879394581,4.767531206054192,49.74521830982723,42.75552841786774,57.24447158213226,58.409790436357746,41.590209563642254
391,ORISSA,Subarnapur,610183,398421,230393,168028,708,176927,16575,193502,286661,181595,105066,65.2953294339567,0.36588769108329633,91.43419706256266,8.56580293743734,46.97951270356598,36.65165474201234,63.34834525798766,57.82652018844389,42.17347981155612
392,ORISSA,Balangir,1648997,927260,545672,381588,3286,476770,62192,538962,720601,469956,250645,56.23175785037814,0.6096904791061336,88.46078202173808,11.539217978261918,43.699351787783726,34.78277160314793,65.21722839685206,58.847788106895585,41.152211893104415
393,ORISSA,Nuapada,610382,299383,180903,118480,757,197258,11869,209127,305438,168155,137283,49.048464731921975,0.3619809971930932,94.32450137954449,5.675498620455513,50.0404664619861,44.94627387554921,55.05372612445078,60.42527464819312,39.57472535180688
394,ORISSA,Kalahandi,1576869,802036,484177,317859,1953,456336,38412,494748,751930,447290,304640,50.86256372596583,0.3947464163574183,92.23604744233428,7.763952557665721,47.68500110028163,40.51440958599869,59.4855904140013,60.368487200075805,39.631512799924195
395,ORISSA,Rayagada,967911,407735,241959,165776,1553,237343,49205,286548,467122,258032,209090,42.125257384201646,0.5419685358124992,82.82835685469799,17.17164314530201,48.26084216420725,44.76132573503282,55.23867426496718,59.34221982415049,40.65778017584951
396,ORISSA,Nabarangapur,1220946,470379,286984,183395,1324,342840,29424,372264,610906,342641,268265,38.52578246703786,0.3556615735069735,92.09593191928309,7.904068080716911,50.035464303908604,43.91264777232504,56.087352227674955,61.01122711685684,38.98877288314317
397,ORISSA,Koraput,1379647,568090,340843,227247,3988,381789,78339,460128,693406,384053,309353,41.17647485190052,0.8667153487725154,82.97452013352806,17.025479866471937,50.259667871564254,44.61354531111643,55.38645468888357,59.99806368709183,40.001936312908164
398,ORISSA,Malkangiri,613192,244706,147001,97705,448,167884,15839,183723,310666,170495,140171,39.906913332202635,0.24384535414727604,91.37886927602968,8.621130723970325,50.663739905282526,45.11951742385713,54.88048257614287,60.072495157454256,39.927504842545744
399,CHHATTISGARH,Koriya,658917,397823,229923,167900,1667,121852,59763,181615,307071,185483,121588,60.375282471085136,0.9178757261239435,67.09357707237838,32.90642292762161,46.602379358857036,39.596054332711326,60.403945667288674,57.795300925285865,42.20469907471413
400,CHHATTISGARH,Surguja,2359886,1187941,694686,493255,2737,525596,65167,590763,1155807,649888,505919,50.33891467638691,0.46329915719163184,88.96901126170732,11.030988738292683,48.97723873102345,43.77192732004565,56.22807267995435,58.47815674347463,41.521843256525365
401,CHHATTISGARH,Jashpur,851669,495415,280656,214759,567,205670,20722,226392,487360,263645,223715,58.16989933882765,0.2504505459556875,90.84684971200396,9.153150287996043,57.224109366432266,45.90343893630992,54.09656106369008,56.65068679793708,43.349313202062916
402,CHHATTISGARH,Raigarh,1493984,951639,542756,408883,3342,354278,66638,420916,690167,429211,260956,63.6980717330306,0.7939826473690712,84.1683376255595,15.831662374440505,46.19641174202669,37.81055889371703,62.18944110628297,57.0338121913877,42.9661878086123
403,CHHATTISGARH,Korba,1206640,748759,433391,315368,4544,206598,126055,332653,521186,333329,187857,62.05322217065571,1.3659879814701805,62.10615866984516,37.89384133015485,43.193164489822976,36.04413779341732,63.95586220658268,57.881240826487556,42.11875917351244
404,CHHATTISGARH,Janjgir - Champa,1619707,1019634,593679,425955,1706,379583,61190,440773,846466,478278,368188,62.951756089218605,0.3870473009916669,86.11757072234461,13.882429277655392,52.26043969680936,43.4970808041906,56.5029191958094,58.22471592747986,41.775284072520144
405,CHHATTISGARH,Bilaspur,2663629,1596560,932474,664086,8566,549632,188174,737806,1203197,715467,487730,59.939278330428145,1.161009804745421,74.4954635771463,25.5045364228537,45.17134330644395,40.53617154962986,59.46382845037014,58.405196171769305,41.594803828230695
406,CHHATTISGARH,Kabeerdham,822526,414167,248503,165664,682,187311,23868,211179,404156,217073,187083,50.353058748294885,0.3229487780508479,88.69773983208557,11.302260167914422,49.135954364968406,46.28979898850939,53.71020101149061,60.000676055793924,39.99932394420608
407,CHHATTISGARH,Rajnandgaon,1537133,1008379,561355,447024,2111,313604,76528,390132,800092,436611,363481,65.60128498965283,0.5410989101124747,80.38407513354454,19.615924866455455,52.05092857937472,45.42990056143543,54.57009943856457,55.66904903810968,44.330950961890316
408,CHHATTISGARH,Durg,3343872,2303378,1284612,1018766,16141,533448,349741,883189,1496805,921729,575076,68.88355774383709,1.8275816388111716,60.40020878883229,39.59979121116771,44.76262847381718,38.42023510076463,61.579764899235364,55.77078534222346,44.22921465777653
409,CHHATTISGARH,Raipur,4063872,2629749,1493158,1136591,20261,673499,395001,1068500,1757664,1099964,657700,64.71042887177549,1.896209639681797,63.03219466541881,36.967805334581186,43.25096853444203,37.41898337793799,62.581016622062016,56.77948731989251,43.22051268010749
410,CHHATTISGARH,Mahasamund,1032754,637963,364089,273874,961,274793,35774,310567,499260,291858,207402,61.772987565286606,0.3094340351679348,88.48106849729687,11.51893150270312,48.3425869084022,41.5418819853383,58.4581180146617,57.070551113465825,42.929448886534175
411,CHHATTISGARH,Dhamtari,799781,546833,303924,242909,1016,168689,41792,210481,402895,226382,176513,68.37284206551544,0.4827039020149087,80.14452610924502,19.855473890754986,50.37566533838639,43.81116668114522,56.18883331885479,55.57894274851737,44.42105725148263
412,CHHATTISGARH,Uttar Bastar Kanker,748941,456042,258298,197744,579,169191,24878,194069,389359,217513,171846,60.8915789094201,0.2983474949631317,87.18084804888983,12.819151951110172,51.987940305044056,44.1356177717736,55.8643822282264,56.63908148810856,43.36091851189145
413,CHHATTISGARH,Bastar,1413199,650863,382335,268528,1782,316425,54894,371319,726531,404364,322167,46.05600485140451,0.47991080445654544,85.21648501692614,14.783514983073854,51.41038169429783,44.343187007849636,55.65681299215037,58.74277689774961,41.25722310225039
414,CHHATTISGARH,Narayanpur,139820,56621,33449,23172,86,26916,6179,33095,71089,38186,32903,40.495637247890144,0.2598579845898172,81.32950596766884,18.670494032331167,50.84322700615077,46.28423525439941,53.71576474560058,59.07525476413345,40.92474523586655
415,CHHATTISGARH,Dakshin Bastar Dantewada,533638,191237,116529,74708,955,106545,31304,137849,286595,153294,133301,35.836465918843864,0.6927870350891193,77.291093878084,22.70890612191601,53.70588301432806,46.51197683141716,53.48802316858284,60.93433802036217,39.06566197963783
416,CHHATTISGARH,Bijapur,255230,86919,54076,32843,117,50449,7942,58391,134525,71591,62934,34.05516592877013,0.20037334520730934,86.39858882362009,13.601411176379921,52.70736198722721,46.78238245679241,53.21761754320759,62.21424544691034,37.78575455308966
417,MADHYA PRADESH,Sheopur,687861,328025,208201,119824,273,150146,26376,176522,277455,183788,93667,47.687686901859536,0.15465494385968886,85.05795311632545,14.942046883674557,40.33591088897321,33.75934836279757,66.24065163720243,63.47107689962655,36.52892310037345
418,MADHYA PRADESH,Morena,1965970,1179685,747652,432033,1781,319298,95288,414586,675993,525329,150664,60.00523914403577,0.42958517653755796,77.01610763508657,22.983892364913434,34.38470576865364,22.287804755374687,77.71219524462532,63.37725748822779,36.62274251177221
419,MADHYA PRADESH,Bhind,1703005,1094917,676513,418404,1166,271211,88385,359596,520768,455775,64993,64.29323460588783,0.32425277255586826,75.42102804258111,24.578971957418883,30.579358252030968,12.480221518987342,87.51977848101265,61.78669250728595,38.21330749271406
420,MADHYA PRADESH,Gwalior,2032036,1357210,803114,554096,15779,172720,272172,444892,685311,548820,136491,66.79064740978998,3.5467034696061064,38.82290533432833,61.177094665671675,33.725337543232506,19.916650980357822,80.08334901964218,59.17389350211095,40.82610649788905
421,MADHYA PRADESH,Datia,786754,491445,303815,187630,616,160453,43401,203854,321160,225662,95498,62.46488737267304,0.3021770482796511,78.70976286950464,21.290237130495353,40.82089191793115,29.735334412753765,70.26466558724623,61.820753085289304,38.1792469147107
422,MADHYA PRADESH,Shivpuri,1726050,900846,573242,327604,1852,367859,66759,434618,759281,481001,278280,52.19118797253846,0.4261213295353621,84.63961455807168,15.360385441928315,43.989513629385016,36.650462740408365,63.349537259591635,63.633739840105854,36.36626015989414
423,MADHYA PRADESH,Tikamgarh,1445166,747940,459353,288587,1090,322772,60220,382992,655318,402776,252542,51.75460812114318,0.2846012449346201,84.27643397251117,15.723566027488825,45.34551740076919,38.53732081218584,61.46267918781416,61.41575527448726,38.58424472551274
424,MADHYA PRADESH,Chhatarpur,1762375,943033,572010,371023,1880,375869,95048,470917,751797,481518,270279,53.50921341939144,0.3992210941630903,79.81640076701414,20.183599232985856,42.658174338605576,35.951061257227686,64.04893874277232,60.65641393249229,39.343586067507715
425,MADHYA PRADESH,Panna,1016520,552559,332140,220419,653,256744,32179,288923,431998,275375,156623,54.35790737024357,0.22601177476351833,88.86243047455551,11.137569525444496,42.49773737850706,36.25549192357372,63.74450807642628,60.10941817977808,39.89058182022192
426,MADHYA PRADESH,Sagar,2378458,1545719,908607,637112,4546,448408,165507,613915,1006035,682077,323958,64.98828232409402,0.7404933907788538,73.04073039427283,26.959269605727176,42.29778284922416,32.20146416377164,67.79853583622835,58.78215898232473,41.21784101767527
427,MADHYA PRADESH,Damoh,1264219,747715,445737,301978,1432,303387,66514,369901,574595,367711,206884,59.1444203891889,0.3871306106228423,82.01843195882141,17.981568041178587,45.45059044358612,36.005186261627756,63.994813738372244,59.613221615187605,40.386778384812395
428,MADHYA PRADESH,Satna,2228935,1371781,801051,570730,3754,461831,114173,576004,911349,590487,320862,61.54423525136444,0.651731585197325,80.1784362608593,19.8215637391407,40.88719500568657,35.20736841758755,64.79263158241244,58.39496246120919,41.60503753879081
429,MADHYA PRADESH,Rewa,2365106,1441757,845572,596185,3406,523910,94489,618399,991946,617184,374762,60.959508791572134,0.55077708728507,84.72038279492689,15.279617205073102,41.940868612231334,37.78048401828325,62.21951598171675,58.64871819592344,41.35128180407656
430,MADHYA PRADESH,Umaria,644758,356672,210907,145765,839,138100,29966,168066,289691,175698,113993,55.318739744214106,0.49920864422310285,82.17009984172886,17.829900158271155,44.93019086230803,39.34985898767997,60.65014101232003,59.13191952269873,40.86808047730127
431,MADHYA PRADESH,Neemuch,826067,508834,307889,200945,1945,174235,67962,242197,418682,245708,172974,61.59718279510016,0.8030652733105695,71.93937166851778,28.060628331482224,50.68378230821471,41.313932769978166,58.686067230021834,60.508731727832654,39.491268272167346
432,MADHYA PRADESH,Mandsaur,1340411,834591,502898,331693,2324,302287,81832,384119,679723,397714,282009,62.26381311403741,0.6050208398959698,78.69618529674398,21.303814703256023,50.71004341205795,41.488812354444384,58.511187645555616,60.2568204066423,39.7431795933577
433,MADHYA PRADESH,Ratlam,1455069,825880,485090,340790,3644,266716,107151,373867,690980,411446,279534,56.75882037209232,0.9746781609502845,71.33980800659057,28.660191993409423,47.48778236633452,40.45471648962343,59.54528351037657,58.73613600038746,41.26386399961253
434,MADHYA PRADESH,Ujjain,1986864,1240990,730817,510173,7501,300765,188684,489449,897442,569425,328017,62.45973554304673,1.5325396517308238,61.449711818800324,38.550288181199676,45.16876847131962,36.55021717280894,63.44978282719106,58.889837951957716,41.110162048042284
435,MADHYA PRADESH,Shajapur,1512681,894612,543509,351103,1382,312611,73997,386608,717871,431857,286014,59.14082347831433,0.3574680296320821,80.85994081860696,19.14005918139304,47.456866318807464,39.84197717974399,60.15802282025601,60.753600443544244,39.246399556455756
436,MADHYA PRADESH,Dewas,1563715,925369,550716,374653,3518,274995,101014,376009,742676,451501,291175,59.17759949862986,0.935615902810837,73.13521750809157,26.86478249190844,47.49433240712022,39.206194895216754,60.79380510478324,59.513123953795734,40.48687604620427
437,MADHYA PRADESH,Dhar,2185793,1077338,638479,438859,2388,412348,103364,515712,1027974,597079,430895,49.28819883676084,0.4630491437081162,79.95703028046661,20.04296971953338,47.02979650863554,41.91691618659616,58.083083813403846,59.26450194832077,40.73549805167923
438,MADHYA PRADESH,Indore,3276697,2309130,1289631,1019499,48691,200371,587947,788318,1268195,939055,329140,70.47127030665331,6.17656833917277,25.417534548240685,74.58246545175932,38.703456560066435,25.953421989520535,74.04657801047946,55.84921593847033,44.15078406152967
439,MADHYA PRADESH,Khargone (West Nimar),1873046,986234,575428,410806,2162,383543,76620,460163,894119,518254,375865,52.654019175183095,0.4698335155151544,83.34937837244628,16.650621627553715,47.736094041470416,42.03746928540832,57.962530714591686,58.345990910879166,41.654009089120834
440,MADHYA PRADESH,Barwani,1385881,549926,313642,236284,1158,250358,48912,299270,653897,365928,287969,39.68060749804636,0.3869415577906239,83.65623016005614,16.343769839943864,47.18276677434787,44.0388929754992,55.9611070245008,57.03349177889388,42.96650822110612
441,MADHYA PRADESH,Rajgarh,1545814,804245,488797,315448,1611,331894,69823,401717,745603,429768,315835,52.0272814193687,0.40102858479974707,82.61885854967552,17.381141450324485,48.23368141315837,42.35967398199846,57.640326018001545,60.7771263731823,39.2228736268177
442,MADHYA PRADESH,Vidisha,1458875,862918,512344,350574,1926,292579,83830,376409,550402,401583,148819,59.1495501670808,0.5116774572340194,77.72901285569687,22.270987144303138,37.72783823151401,27.03823750640441,72.9617624935956,59.37342829793793,40.62657170206207
443,MADHYA PRADESH,Bhopal,2371061,1660690,920314,740376,40788,118893,581826,700719,867457,644960,222497,70.03995257819179,5.820878269320512,16.967286458623214,83.0327135413768,36.585182751519255,25.649340543681127,74.35065945631887,55.41756739668451,44.58243260331549
444,MADHYA PRADESH,Sehore,1311332,780362,469208,311154,1566,270427,59220,329647,586087,364559,221528,59.509109821158944,0.47505361796103107,82.03532870009434,17.964671299905657,44.694021041200855,37.797801350311474,62.202198649688526,60.12696671544745,39.873033284552555
445,MADHYA PRADESH,Raisen,1331597,820220,479093,341127,1141,251272,74441,325713,517838,370366,147472,61.59671432122481,0.35030840034017674,77.1452168012944,22.854783198705608,38.88849253940945,28.47840444308838,71.52159555691162,58.410304552437154,41.589695447562846
446,MADHYA PRADESH,Betul,1575362,939769,529783,409986,2109,318945,87704,406649,786980,453887,333093,59.654162027521295,0.5186290879849698,78.43250567442685,21.56749432557316,49.955502290902025,42.32547205773972,57.67452794226029,56.373747165526844,43.62625283447315
447,MADHYA PRADESH,Harda,570465,352550,203807,148743,986,112714,31845,144559,230979,156852,74127,61.80046102740746,0.68207444711156,77.97093228370423,22.02906771629577,40.48960058899319,32.09252789214604,67.90747210785396,57.80938873918593,42.19061126081407
448,MADHYA PRADESH,Hoshangabad,1241350,810644,469199,341445,2871,209650,105746,315396,478082,345435,132647,65.3034196640754,0.910284214130807,66.47199076716255,33.52800923283745,38.51307044749668,27.745658694533574,72.25434130546643,57.879784467657814,42.120215532342186
449,MADHYA PRADESH,Katni,1292042,790773,460583,330190,2179,276151,72880,349031,543874,348410,195464,61.20335097465872,0.6242998472915013,79.11933323974088,20.880666760259118,42.09414245047762,35.939206507389585,64.06079349261043,58.244654281317146,41.755345718682854
450,MADHYA PRADESH,Jabalpur,2463289,1756468,980307,776161,20443,272284,352477,624761,1005624,705970,299654,71.30580293258323,3.2721312629949693,43.58210579725687,56.41789420274313,40.82444244260417,29.797817076760303,70.2021829232397,55.81126442383238,44.18873557616762
451,MADHYA PRADESH,Narsimhapur,1091854,718785,413491,305294,1603,230659,53059,283718,477818,323464,154354,65.83160385912402,0.5649976385002009,81.29868390444032,18.701316095559676,43.762078080036346,32.30393162250062,67.69606837749939,57.526381324039875,42.473618675960125
452,MADHYA PRADESH,Dindori,704524,378714,222759,155955,554,218021,9774,227795,389925,203383,186542,53.754591752729496,0.24320112381746745,95.70930002853443,4.290699971465572,55.34587891966775,47.84048214400205,52.15951785599795,58.819848223197454,41.180151776802546
453,MADHYA PRADESH,Mandla,1054905,604962,348033,256929,912,279674,37258,316932,559649,300235,259414,57.347533664168814,0.2877588883419787,88.24416594095894,11.755834059041057,53.05207577933558,46.3529819583346,53.647018041665405,57.5297291400121,42.4702708599879
454,MADHYA PRADESH,Chhindwara,2090922,1294198,731294,562904,3588,413142,140802,553944,957984,582263,375721,61.89604394616346,0.6477189029938044,74.5819071963953,25.418092803604697,45.81634322083751,39.21996609546714,60.78003390453285,56.5055733357647,43.494426664235306
455,MADHYA PRADESH,Seoni,1379131,864194,485341,378853,1182,335045,47542,382587,684434,394660,289774,62.66221265420037,0.308949337013542,87.57354536353823,12.426454636461772,49.62791787002105,42.337756452777036,57.66224354722296,56.16111660113354,43.83888339886646
456,MADHYA PRADESH,Balaghat,1701698,1147623,626468,521155,1712,400074,70793,470867,893014,488610,404404,67.43987476038639,0.3635846215598035,84.96539362495142,15.03460637504858,52.47781921351498,45.28529227985227,54.71470772014773,54.58830992407786,45.411690075922145
457,MADHYA PRADESH,Guna,1241519,653980,400537,253443,2482,212765,72320,285085,514897,335454,179443,52.67579473209834,0.8706175351211043,74.63212726029079,25.367872739709206,41.47314700781865,34.8502710250788,65.14972897492119,61.24606257072082,38.75393742927918
458,MADHYA PRADESH,Ashoknagar,845071,469109,290304,178805,619,169606,37135,206741,315270,231829,83441,55.51119373401762,0.29940843857773736,82.03791217030005,17.962087829699964,37.30692450693492,26.46652075998351,73.5334792400165,61.88412501145789,38.11587498854211
459,MADHYA PRADESH,Shahdol,1066063,604194,348761,255433,1733,233594,57846,291440,493057,292402,200655,56.67526215617651,0.5946335437825968,80.15166071918748,19.848339280812517,46.25026851133563,40.69610612971725,59.30389387028274,57.72334713684677,42.276652863153224
460,MADHYA PRADESH,Anuppur,749237,436595,254120,182475,1290,147388,60325,207713,346471,207401,139070,58.27194866243926,0.6210492362057262,70.95752312084463,29.04247687915537,46.24317805981285,40.139001532595806,59.8609984674042,58.20497257183431,41.795027428165696
461,MADHYA PRADESH,Sidhi,1127033,600785,353030,247755,837,250953,25916,276869,461760,284289,177471,53.306779836970165,0.30230903423640787,90.639616569569,9.360383430430998,40.97129365333579,38.43360187110187,61.56639812889813,58.7614537646579,41.23854623534209
462,MADHYA PRADESH,Singrauli,1178273,585054,359923,225131,2627,228732,58593,287325,499439,304234,195205,49.65351832724674,0.9142956582267467,79.60741320803967,20.392586791960323,42.387375421485515,39.08485320529634,60.91514679470366,61.51962041110735,38.480379588892646
463,MADHYA PRADESH,Jhabua,1025048,352081,214582,137499,744,211080,24713,235793,515121,265489,249632,34.34775737331325,0.3155309954069883,89.5191969227246,10.480803077275407,50.2533539892766,48.46084706311721,51.53915293688279,60.946770771498606,39.053229228501394
464,MADHYA PRADESH,Alirajpur,728999,209754,120905,88849,297,135866,14662,150528,366797,188698,178099,28.77287897514263,0.19730548469387754,90.25961947278913,9.740380527210885,50.31515818265868,48.5551953805511,51.4448046194489,57.64133222727577,42.35866777272424
465,MADHYA PRADESH,Khandwa (East Nimar),1310061,731615,432259,299356,1907,265663,63425,329088,612976,369676,243300,55.845872825769185,0.5794802605989887,80.72703957604045,19.27296042395955,46.78988230319046,39.69160293388322,60.30839706611678,59.082850953028576,40.917149046971424
466,MADHYA PRADESH,Burhanpur,757847,408679,233073,175606,986,115979,62861,178840,328339,211925,116414,53.92632022030832,0.5513307984790874,64.85070454037128,35.14929545962872,43.325235832562505,35.4554286880328,64.5445713119672,57.03082370271044,42.96917629728956
467,GUJARAT,Kachchh,2092371,1252319,739239,513080,9631,488293,250982,739275,776228,624704,151524,59.851670664523645,1.302762841973555,66.0502519360184,33.9497480639816,37.09800986536326,19.520553239512104,80.47944676048789,59.029608270736134,40.97039172926387
468,GUJARAT,Banas Kantha,3120506,1704923,1048402,656521,3424,666773,137424,804197,1248600,836268,412332,54.63610709288814,0.4257663234257278,82.91164975745993,17.088350242540074,40.01274152332987,33.02354637193657,66.97645362806342,61.49263045897088,38.50736954102912
469,GUJARAT,Patan,1343734,837913,494631,343282,2231,301483,102655,404138,554830,383074,171756,62.3570587631183,0.5520391549421237,74.59902310596875,25.400976894031245,41.29016605965169,30.95650920101653,69.04349079898347,59.03130754624883,40.96869245375117
470,GUJARAT,Mahesana,2035064,1502645,847499,655146,7759,476005,183738,659743,812064,588699,223365,73.83772697074883,1.1760640128049862,72.15006449481086,27.849935505189144,39.90360991103965,27.50583697836624,72.49416302163377,56.40048048607622,43.59951951392378
471,GUJARAT,Sabar Kantha,2428589,1578734,918625,660109,5262,544024,121509,665533,1084878,681435,403443,65.00622377849854,0.7906444909568721,81.7426032969064,18.25739670309361,44.6711238501039,37.18786812895091,62.81213187104909,58.18744639692311,41.81255360307689
472,GUJARAT,Gandhinagar,1391753,1030494,582686,447808,12107,237624,195634,433258,534976,408075,126901,74.04287973512541,2.794408874158123,54.84584243106878,45.15415756893121,38.439004622228225,23.720877198229452,76.27912280177055,56.54433698789124,43.45566301210876
473,GUJARAT,Ahmadabad,7214225,5435760,3025463,2410297,126341,353169,1845383,2198552,2594952,2127547,467405,75.34780243200066,5.746555005294394,16.063709204967633,83.93629079503236,35.96993440043803,18.01208654341198,81.98791345658802,55.658509573638284,44.34149042636172
474,GUJARAT,Surendranagar,1756268,1093626,643221,450405,2975,340788,159810,500598,723500,504038,219462,62.269881362070024,0.5942892300808233,68.07618088765835,31.92381911234164,41.195307322117124,30.3333794056669,69.66662059433311,58.81544513389404,41.18455486610596
475,GUJARAT,Rajkot,3804558,2725056,1514075,1210981,21785,459474,721532,1181006,1479050,1159480,319570,71.62608639426709,1.8446138292269474,38.90530615424478,61.09469384575523,38.875737996371726,21.606436564010682,78.39356343598932,55.56124351205993,44.43875648794006
476,GUJARAT,Jamnagar,2160119,1396534,795140,601394,11573,347158,299167,646325,847440,646822,200618,64.65079007221361,1.7905852318879822,53.71260588713108,46.28739411286891,39.23117198635816,23.673416407061268,76.32658359293873,56.93667322098853,43.06332677901147
477,GUJARAT,Porbandar,585449,393678,221621,172057,1653,96015,87557,183572,231169,174118,57051,67.24377358232742,0.9004641230688776,52.30372823742183,47.69627176257817,39.485762209859445,24.67934714429703,75.32065285570297,56.29499235415746,43.70500764584254
478,GUJARAT,Junagadh,2743082,1842818,1046981,795837,6628,489237,287506,776743,1123709,801859,321850,67.18056550988997,0.8533066921748893,62.98569797217355,37.01430202782645,40.96519899879041,28.641756896135924,71.35824310386408,56.81412923034179,43.18587076965821
479,GUJARAT,Amreli,1514190,995459,558180,437279,2538,313714,116899,430613,657139,453642,203497,65.74201388200952,0.5893923313973336,72.85288646650241,27.147113533497595,43.39871482442758,30.967116546118856,69.03288345388114,56.07262579372932,43.92737420627068
480,GUJARAT,Bhavnagar,2880365,1887255,1087371,799884,7297,387251,356826,744077,1150632,838781,311851,65.52138357465113,0.980678074984175,52.04447926760268,47.95552073239732,39.947437217158246,27.102583623608588,72.8974163763914,57.61653830563437,42.38346169436563
481,GUJARAT,Anand,2092745,1551253,874481,676772,9902,413078,208909,621987,844794,627561,217233,74.12527565470232,1.5919946879918712,66.41264206486632,33.587357935133696,40.3677466676542,25.714316152813588,74.28568384718642,56.37255818361028,43.62744181638972
482,GUJARAT,Kheda,2299885,1660243,942480,717763,5710,461479,160547,622026,933983,674586,259397,72.18808766525284,0.9179680592129589,74.18966409764222,25.810335902357778,40.609987021090184,27.773203580793226,72.22679641920678,56.76759365948237,43.23240634051762
483,GUJARAT,Panch Mahals,2390776,1440805,858054,582751,3456,463363,104238,567601,1097507,673565,423942,60.26516076788457,0.6088784198759339,81.63533890884618,18.36466109115382,45.9058899704531,38.62772629240634,61.37227370759366,59.55379110983097,40.44620889016904
484,GUJARAT,Dohad,2127086,1007171,599035,408136,1733,323697,52807,376504,999124,540881,458243,47.349801559504414,0.4602872745043877,85.97438539829591,14.025614601704097,46.971490574429055,45.86447728209912,54.13552271790088,59.47699050111649,40.5230094988835
485,GUJARAT,Vadodara,4165626,2893080,1614087,1278993,53606,547454,692971,1240425,1693473,1233312,460161,69.45126614823319,4.321583328294738,44.13438942298002,55.86561057701998,40.65350561956354,27.172620998386154,72.82737900161385,55.79130200340122,44.20869799659878
486,GUJARAT,Narmada,590297,370336,211767,158569,576,138121,22248,160369,294795,174282,120513,62.73723227460075,0.35917166035829867,86.12699461866072,13.873005381339286,49.94011489131742,40.88027273189844,59.11972726810156,57.18239652639765,42.81760347360235
487,GUJARAT,Bharuch,1551019,1118276,623047,495229,10257,300677,181319,481996,627124,468919,158205,72.09943914291186,2.128025958721649,62.38163802189229,37.6183619781077,40.43303144577855,25.227068330983982,74.77293166901602,55.71495766698025,44.28504233301975
488,GUJARAT,The Dangs,228291,140968,77314,63654,137,52102,7516,59618,118257,61329,56928,61.749258621671466,0.22979637022375793,87.39306920728639,12.60693079271361,51.80099084063761,48.13922220249118,51.86077779750882,54.845071221837586,45.154928778162414
489,GUJARAT,Navsari,1329672,1001909,539471,462438,6726,267739,141417,409156,591834,407881,183953,75.35008633708162,1.6438717750686778,65.43689937334415,34.563100626655846,44.50977383896179,31.08185741272046,68.91814258727955,53.8443112099003,46.155688790099695
490,GUJARAT,Valsad,1705678,1170657,655528,515129,11020,262410,235981,498391,743245,516188,227057,68.63294244282918,2.2111153692582732,52.65143230917091,47.348567690829086,43.57475443782472,30.549415065018938,69.45058493498107,55.996589949062795,44.003410050937205
491,GUJARAT,Surat,6081322,4571410,2687468,1883942,55694,369840,1529998,1899838,2553542,2142819,410723,75.17131965714033,2.931513107959731,19.466922969221585,80.53307703077841,41.98991600839423,16.084442707423648,83.91555729257635,58.788601328692906,41.2113986713071
492,GUJARAT,Tapi,807022,490036,269007,221029,1601,192272,26217,218489,450902,251049,199853,60.7215168855372,0.7327600016476802,88.00076891742835,11.999231082571663,55.8723306180005,44.32293491712168,55.67706508287832,54.895354627006995,45.104645372993005
493,DAMAN AND DIU,Diu,52074,38058,20327,17731,368,9788,9062,18850,15750,12932,2818,73.08445673464685,1.9522546419098143,51.92572944297083,48.07427055702917,30.245419979260284,17.892063492063492,82.1079365079365,53.41058384570918,46.58941615429082
494,DAMAN AND DIU,Daman,191173,150348,104316,46032,1316,10006,61073,71079,105521,94502,11019,78.64499693994445,1.8514610503805624,14.077294278197499,85.9227057218025,55.19660203062148,10.442471166876736,89.55752883312327,69.38303136722803,30.616968632771968
495,DADRA AND NAGAR HAVELI,Dadra AND Nagar Haveli,343709,223230,142521,80709,2013,48221,60562,108783,157161,119293,37868,64.94738281511395,1.8504729599294008,44.327698261676915,55.672301738323085,45.72501738389161,24.095036300354415,75.90496369964559,63.8449133181024,36.1550866818976
496,MAHARASHTRA,Nandurbar,1648295,906509,512099,394410,2579,333440,71572,405012,792065,442898,349167,54.99676938897466,0.6367712561603113,82.32842483679495,17.67157516320504,48.05359477520711,44.08312449104555,55.91687550895445,56.49133102925619,43.508668970743805
497,MAHARASHTRA,Dhule,2050862,1293916,723388,570528,6065,382777,146013,528790,936370,570448,365922,63.09132452597981,1.1469581497380814,72.38733712816052,27.612662871839483,45.65738699142117,39.07878295972746,60.921217040272545,55.906874943968546,44.093125056031454
498,MAHARASHTRA,Jalgaon,4229917,2891882,1629223,1262659,14297,796223,373565,1169788,1863571,1186472,677099,68.36734621506758,1.2221872681203774,68.06558111384285,31.93441888615715,44.05691648323123,36.33341579150996,63.66658420849004,56.33781046391243,43.66218953608757
499,MAHARASHTRA,Buldana,2586258,1879874,1048892,830982,4767,575405,152787,728192,1219641,734024,485617,72.68702503771858,0.654635041307787,79.01830835823519,20.98169164176481,47.15852014764188,39.816388593036805,60.1836114069632,55.79586716982096,44.20413283017904
500,MAHARASHTRA,Akola,1813906,1411281,758977,652304,6163,308158,196077,504235,768154,520362,247792,77.80342531531403,1.2222475631402023,61.11396471883149,38.8860352811685,42.348059932543364,32.25811490924997,67.74188509075003,53.77929696495595,46.220703035044046
501,MAHARASHTRA,Washim,1197160,869917,487703,382214,1875,274925,55921,330846,569792,340353,229439,72.66505730228207,0.5667289312852505,83.09757409791867,16.90242590208133,47.595308897724614,40.267150117937774,59.732849882062226,56.06316464674216,43.93683535325784
502,MAHARASHTRA,Amravati,2888445,2251875,1207104,1044771,9438,508921,272894,781815,1236322,837577,398745,77.96149831483721,1.207190959498091,65.09481143237211,34.905188567627896,42.802338282363,32.25251997456973,67.74748002543028,53.60439633638634,46.395603663613656
503,MAHARASHTRA,Wardha,1300774,1019458,552617,466841,4313,268486,120218,388704,608235,392316,215919,78.37318396585418,1.1095846711122088,69.07209599077962,30.927904009220384,46.75946782454139,35.49927248514144,64.50072751485857,54.206941335493966,45.79305866450604
504,MAHARASHTRA,Nagpur,4653570,3673808,1959220,1714588,57964,430844,877522,1308366,1868560,1334211,534349,78.94601349071789,4.430258811372353,32.92992939284573,67.07007060715426,40.153258680969664,28.59683392558976,71.40316607441024,53.329406436046746,46.67059356395326
505,MAHARASHTRA,Bhandara,1200334,899860,488709,411151,2932,283843,72575,356418,597305,345054,252251,74.9674673882436,0.8226296090545371,79.63767262035026,20.362327379649734,49.76156636402868,42.23152325863671,57.768476741363294,54.30944813637677,45.69055186362323
506,MAHARASHTRA,Gondiya,1322507,1004243,542837,461406,2866,319702,66813,386515,665419,383151,282268,75.93479656440381,0.7414977426490563,82.71399557585087,17.286004424149127,50.3149699774746,42.41958825942752,57.58041174057248,54.054347403964975,45.945652596035025
507,MAHARASHTRA,Gadchiroli,1072942,708365,395110,313255,1663,293586,37254,330840,584237,323338,260899,66.02081007174667,0.5026598960222464,88.73957199854915,11.260428001450853,54.451871582993306,44.6563637701823,55.3436362298177,55.77774170095925,44.22225829904075
508,MAHARASHTRA,Chandrapur,2204307,1578615,872565,706050,8239,451324,233331,684655,1058172,648565,409607,71.61502458595831,1.2033798044270472,65.91991587003673,34.08008412996327,48.00474707016763,38.70892444706532,61.29107555293468,55.274085194933534,44.725914805066466
509,MAHARASHTRA,Yavatmal,2772348,2022574,1115980,906594,6094,629243,168889,798132,1355999,815475,540524,72.9552711275785,0.7635328492028888,78.83946515112788,21.160534848872118,48.911572428858136,39.86168131392427,60.138318686075735,55.176225937839604,44.823774062160396
510,MAHARASHTRA,Nanded,3361292,2189425,1255222,934203,7548,591119,230563,821682,1493953,925232,568721,65.13641183211693,0.9186035473577369,71.9401179531741,28.0598820468259,44.44579643779832,38.06819893263041,61.931801067369584,57.33112575219521,42.66887424780479
511,MAHARASHTRA,Hingoli,1177345,790743,450551,340192,1221,242456,41913,284369,569182,330903,238279,67.16323592489883,0.4293716966335993,85.26105166174935,14.738948338250655,48.34453792218933,41.86341100034787,58.136588999652126,56.97818380940457,43.02181619059543
512,MAHARASHTRA,Parbhani,1836086,1157814,666291,491523,3982,293480,133759,427239,822797,501422,321375,63.058810970727954,0.9320310177675727,68.69223081226198,31.30776918773801,44.81255235321221,39.05884440512059,60.94115559487941,57.547326254476104,42.452673745523896
513,MAHARASHTRA,Jalna,1959046,1195523,699428,496095,3791,404746,98084,502830,930886,545030,385856,61.02577479038267,0.7539327406877075,80.49360618897042,19.506393811029575,47.51731199777851,41.45040316429724,58.54959683570276,58.50393509786094,41.49606490213906
514,MAHARASHTRA,Aurangabad,3701282,2503837,1430936,1072901,23258,551789,427343,979132,1575079,1015864,559215,67.64783121091557,2.375369204560774,56.354914352712406,43.645085647287594,42.55495798482796,35.503933453496614,64.49606654650339,57.149726599614915,42.85027340038509
515,MAHARASHTRA,Nashik,6107187,4345366,2397538,1947828,45039,904661,764271,1668932,2763328,1746286,1017042,71.15167752354725,2.6986719650650834,54.20598322759705,45.79401677240295,45.24714897382379,36.80496850174861,63.19503149825139,55.17459288814797,44.82540711185203
516,MAHARASHTRA,Thane,11060148,8227161,4591396,3635765,256170,713994,2904157,3618151,4492767,3363123,1129644,74.38563209099914,7.080135682562723,19.733670595837488,80.26632940416252,40.6212195352178,25.14361416917459,74.85638583082542,55.80778108025356,44.19221891974644
517,MAHARASHTRA,Mumbai Suburban,9356962,7575485,4223029,3352456,404757,0,3078829,3078829,3735021,2944322,790699,80.96094651234023,13.146459254476294,0.0,100.0,39.91702648787074,21.16986758575119,78.83013241424881,55.74598854066769,44.254011459332304
518,MAHARASHTRA,Mumbai,3085411,2509022,1410680,1098342,121344,0,1107321,1107321,1284396,1021009,263387,81.31889074097421,10.958339993552006,0.0,100.0,41.628035940754735,20.50668173989953,79.49331826010047,56.224297754264406,43.77570224573559
519,MAHARASHTRA,Raigarh,2634200,1939994,1059692,880302,38570,581868,377160,959028,1072969,753843,319126,73.64642016551515,4.021780385974132,60.672681089603216,39.32731891039678,40.73225267633437,29.742331791505627,70.25766820849438,54.62346790763271,45.37653209236729
520,MAHARASHTRA,Pune,9429408,7171723,3940210,3231513,235018,1165718,2056739,3222457,4048993,2809816,1239177,76.05698045943076,7.293130676375201,36.17481940022784,63.82518059977216,42.94005519752672,30.604572544333863,69.39542745566614,54.94091168886472,45.05908831113528
521,MAHARASHTRA,Ahmadnagar,4543159,3151890,1773355,1378535,18370,1041393,282011,1323404,2204590,1300309,904281,69.37661657890469,1.3880870845184086,78.69048302710283,21.309516972897168,48.52548634111199,41.01810313935925,58.98189686064076,56.26322619126937,43.73677380873063
522,MAHARASHTRA,Bid,2585049,1718507,987185,731322,5614,563114,135457,698571,1255548,727819,527729,66.4787011774245,0.8036405748306185,80.60941550679888,19.39058449320112,48.5696015820203,42.0317662088586,57.9682337911414,57.44433976701869,42.5556602329813
523,MAHARASHTRA,Latur,2454196,1650672,932432,718240,6217,428616,157016,585632,1046857,670018,376839,67.25917571375717,1.0615881645811704,73.18862357248238,26.811376427517626,42.65580255203741,35.99718013061956,64.00281986938045,56.48802427132708,43.51197572867293
524,MAHARASHTRA,Osmanabad,1657576,1137810,644304,493506,3209,367158,77832,444990,773916,473795,300121,68.64300641418554,0.7211398008944021,82.50926987123306,17.490730128766938,46.689623884515704,38.77953162875558,61.22046837124443,56.62667756479552,43.37332243520447
525,MAHARASHTRA,Solapur,4317756,2910676,1651266,1259410,15145,779929,376302,1156231,1898395,1206933,691462,67.41177593175715,1.3098593620133,67.45442735923876,32.545572640761236,43.967167204446014,36.42350511879772,63.57649488120229,56.731357251717476,43.26864274828253
526,MAHARASHTRA,Satara,3003741,2225694,1201034,1024660,14093,774522,200949,975471,1354947,844805,510142,74.09740054152472,1.444737977858901,79.39979763621882,20.60020236378119,45.10864951405597,37.65032875824663,62.34967124175337,53.9622248161697,46.037775183830306
527,MAHARASHTRA,Ratnagiri,1615069,1199392,619012,580380,7752,538538,100824,639362,714076,407008,307068,74.26258568519364,1.2124586697363935,84.23052980940375,15.769470190596252,44.21334320700849,43.00214542989822,56.99785457010178,51.6104826445399,48.3895173554601
528,MAHARASHTRA,Sindhudurg,849651,666067,348289,317778,3517,295847,44989,340836,347178,229676,117502,78.39301077736623,1.0318745672405496,86.80039667171309,13.19960332828692,40.861247735835065,33.844886484742695,66.1551135152573,52.290385201488746,47.70961479851126
529,MAHARASHTRA,Kolhapur,3876001,2825845,1559760,1266085,22269,796496,382818,1179314,1704054,1125204,578850,72.90619894060914,1.888301164914518,67.5389251717524,32.46107482824761,43.964230143387475,33.96899394033287,66.03100605966712,55.19623333905434,44.80376666094566
530,MAHARASHTRA,Sangli,2822143,2049467,1121550,927917,13212,626872,226801,853673,1215104,800214,414890,72.62094798172878,1.5476652067009264,73.43233298932964,26.56766701067036,43.05607476304355,34.14440245444011,65.85559754555989,54.723984333487685,45.27601566651232
531,ANDHRA PRADESH,Adilabad,2741239,1483347,856350,626997,5512,597466,220248,817714,1323667,748939,574728,54.112282803506005,0.6740743095996888,73.06539939392013,26.93460060607988,48.28717962935738,43.41937964760019,56.58062035239981,57.73092877121806,42.26907122878193
532,ANDHRA PRADESH,Nizamabad,2551335,1389810,790214,599596,5261,565165,155133,720298,1261076,684320,576756,54.47383428675576,0.7303921432518208,78.46266406404017,21.537335935959838,49.428083728714576,45.735229280392296,54.264770719607704,56.85769997337765,43.142300026622344
533,ANDHRA PRADESH,Karimnagar,3776269,2206829,1257238,949591,8831,877236,288044,1165280,1876768,1049463,827305,58.43940143035361,0.7578436084031306,75.28113414801592,24.718865851984074,49.699001845472345,44.0813675424986,55.9186324575014,56.97034070152242,43.02965929847759
534,ANDHRA PRADESH,Medak,3033288,1637137,953406,683731,8635,593653,195479,789132,1442203,837874,604329,53.972356070376435,1.0942402538485323,75.22860560717345,24.771394392826547,47.545864421710036,41.90318561256633,58.09681438743367,58.23617693571155,41.76382306428845
535,ANDHRA PRADESH,Hyderabad,3943323,2892155,1542688,1349467,149034,0,1066289,1066289,1413297,1045585,367712,73.34309160066269,13.976886191267097,0.0,100.0,35.84025452644888,26.01802735023141,73.9819726497686,53.34043299892295,46.65956700107705
536,ANDHRA PRADESH,Rangareddy,5296741,3538028,1948784,1589244,142879,432098,1129224,1561322,2196078,1488916,707162,66.79631871749062,9.151155238957754,27.67513683916578,72.32486316083421,41.46092852189677,32.201133110936865,67.79886688906313,55.081079064382756,44.91892093561724
537,ANDHRA PRADESH,Mahbubnagar,4053028,1940646,1158386,782260,6153,848963,161052,1010015,2082501,1140067,942434,47.881386459703705,0.6091988732840601,84.05449424018455,15.945505759815449,51.38136228025072,45.25491224253914,54.745087757460865,59.69074215493192,40.30925784506809
538,ANDHRA PRADESH,Nalgonda,3488809,2001019,1160757,840262,7715,833504,197433,1030937,1741693,976428,765265,57.35536109887357,0.7483483471831935,80.84916925088535,19.15083074911464,49.92228006749581,43.93799596140078,56.06200403859922,58.00829477381274,41.99170522618726
539,ANDHRA PRADESH,Warangal,3512576,2065023,1179790,885233,12952,758738,288249,1046987,1705655,960926,744729,58.78941836418628,1.2370736217355134,72.46871260101607,27.531287398983938,48.558522292471395,43.662346723106374,56.337653276893626,57.132051313714186,42.867948686285814
540,ANDHRA PRADESH,Khammam,2797370,1630234,901640,728594,8628,669262,201363,870625,1410062,802906,607156,58.27738196949277,0.9910122038765256,76.87144292893036,23.128557071069633,50.406703439301914,43.05881585348729,56.941184146512704,55.30739758832167,44.69260241167832
541,ANDHRA PRADESH,Srikakulam,2703114,1495381,857824,637557,3988,752752,149684,902436,1290288,766483,523805,55.32067829917643,0.4419149945259276,83.41333900686585,16.58666099313414,47.73339193241573,40.595975472142655,59.404024527857345,57.36491235344035,42.63508764655964
542,ANDHRA PRADESH,Vizianagaram,2344474,1238388,707503,530885,4453,592458,157056,749514,1157962,679289,478673,52.82157106455435,0.5941183220059932,79.04562156277267,20.954378437227323,49.391121419985886,41.33753957383748,58.662460426162525,57.130963801328825,42.869036198671175
543,ANDHRA PRADESH,Visakhapatnam,4290589,2568249,1422878,1145371,45492,718847,660493,1379340,1889879,1239064,650815,59.857725827386396,3.2980990908695462,52.11528702132904,47.884712978670954,44.04707605412683,34.43686077256798,65.56313922743202,55.40264982094805,44.59735017905195
544,ANDHRA PRADESH,East Godavari,5154296,3288577,1716933,1571644,22411,1199479,406362,1605841,2093681,1545831,547850,63.80264152466215,1.3955927143471862,74.69475496017351,25.305245039826485,40.620115724824494,26.16683248307646,73.83316751692355,52.2089949543526,47.7910050456474
545,ANDHRA PRADESH,West Godavari,3936966,2652389,1379223,1273166,12050,1007255,248373,1255628,1773112,1199338,573774,67.37139716218022,0.9596791406371951,80.21922097946207,19.78077902053793,45.03752381910334,32.35971557352271,67.6402844264773,51.99927310813006,48.00072689186993
546,ANDHRA PRADESH,Krishna,4517398,3009718,1598959,1410759,30438,909292,567042,1476334,2048880,1327299,721581,66.62503503122815,2.0617285790342836,61.59121174476778,38.40878825523222,45.355312947851836,35.2183143961579,64.78168560384209,53.12653876542587,46.87346123457414
547,ANDHRA PRADESH,Guntur,4887813,2960441,1634726,1325715,19383,1069877,513113,1582990,2381624,1442370,939254,60.56780404651324,1.2244549870814092,67.5858344019861,32.41416559801388,48.725759352904866,39.43754345774144,60.56245654225856,55.21900284450864,44.780997155491356
548,ANDHRA PRADESH,Prakasam,3397448,1904435,1107686,796749,6151,873486,214089,1087575,1700567,991842,708725,56.054868242280676,0.5655701905615704,80.31501275774085,19.684987242259155,50.054246599212114,41.67580577536786,58.324194224632144,58.163497310225864,41.83650268977413
549,ANDHRA PRADESH,Sri Potti Sriramulu Nellore,2963557,1832189,1011922,820267,10201,689137,264376,953513,1314561,859880,454681,61.82398381404508,1.0698333425973217,72.27347713140774,27.726522868592244,44.35754061757544,34.58804878586844,65.41195121413156,55.23021915315505,44.769780846844945
550,ANDHRA PRADESH,Y.S.R.,2882469,1716766,994699,722067,6667,590589,293504,884093,1320404,823886,496518,59.55887123157265,0.7541061856614633,66.80168262841126,33.198317371588736,45.80809021710208,37.603491052738406,62.396508947261594,57.940278407191194,42.0597215928088
551,ANDHRA PRADESH,Kurnool,4053463,2127161,1246369,880792,10081,783853,306982,1090835,2029425,1164122,865303,52.47762222080231,0.9241544321551838,71.85807202739186,28.141927972608137,50.066449354539564,42.637840767705136,57.362159232294864,58.59307311482299,41.406926885177
552,ANDHRA PRADESH,Anantapur,4081148,2310960,1338474,972486,8606,902997,341431,1244428,2036166,1208544,827622,56.62524368143473,0.6915627099358099,72.56321779966378,27.436782200336218,49.891991175032125,40.6460966345573,59.3539033654427,57.9185273652508,42.0814726347492
553,ANDHRA PRADESH,Chittoor,4174064,2667878,1484794,1183084,13763,907970,395900,1303870,1933357,1202223,731134,63.915598802509976,1.055550016489374,69.63654352044298,30.363456479557012,46.318336278504596,37.81681293211756,62.18318706788244,55.65449394612497,44.34550605387503
554,KARNATAKA,Belgaum,4779661,3052032,1725548,1326484,17560,962777,356198,1318975,2105668,1372422,733246,63.85457043920061,1.3313368335260334,72.99433272048371,27.00566727951629,44.054756184591334,34.822488635435406,65.1775113645646,56.53767719342392,43.462322806576076
555,KARNATAKA,Bagalkot,1889752,1113412,641388,472024,3745,324799,165858,490657,818081,511575,306506,58.9184189248113,0.7632623197060268,66.1967525175428,33.803247482457195,43.29038942676076,37.466461145045535,62.533538854954465,57.605630260855825,42.394369739144175
556,KARNATAKA,Bijapur,2177331,1248268,730566,517702,4987,396449,131041,527490,927722,580111,347611,57.330190035414915,0.9454207662704507,75.15763332006294,24.84236667993706,42.60822079876693,37.46930653794995,62.53069346205006,58.52637414401395,41.47362585598605
557,KARNATAKA,Bidar,1703300,1042673,597198,445475,3971,287134,102269,389403,702608,459050,243558,61.21487700346386,1.019766154857564,73.73697685944896,26.263023140551052,41.24980919391769,34.664848678068,65.335151321932,57.27567511578414,42.72432488421586
558,KARNATAKA,Raichur,1928812,979769,577213,402556,5200,330446,125402,455848,903413,530373,373040,50.79650064391967,1.140731120899949,72.49039153402012,27.50960846597989,46.83779445586195,41.29229931382435,58.70770068617565,58.91317239063494,41.08682760936506
559,KARNATAKA,Koppal,1389920,809085,468785,340300,2135,272968,64681,337649,654766,387974,266792,58.210904224703576,0.6323134379192593,80.84371640372102,19.156283596278975,47.10817888799355,40.74615969674662,59.253840303253384,57.940142259465944,42.05985774053406
560,KARNATAKA,Gadag,1064570,700177,397178,302999,3373,180066,111906,291972,495722,310412,185310,65.77087462543562,1.1552477634841696,61.672352143356214,38.327647856643786,46.56546774754126,37.38183901460899,62.618160985391,56.72537087050846,43.274629129491544
561,KARNATAKA,Dharwad,1847023,1301664,711776,589888,15013,199707,283397,483104,784833,543776,241057,70.47362160622797,3.107612439557528,41.3383039676757,58.66169603232431,42.4917827227923,30.714432242273197,69.28556775772681,54.682007031000325,45.31799296899968
562,KARNATAKA,Uttara Kannada,1437169,1081906,582099,499807,6129,334281,140511,474792,608526,430565,177961,75.28036020815924,1.2908810594955265,70.40577768791387,29.59422231208613,42.34199318243018,29.24460088804751,70.75539911195249,53.80310304222363,46.19689695777637
563,KARNATAKA,Haveri,1597668,1085443,603793,481650,2456,315076,98488,413564,730066,490731,239335,67.93920889696733,0.5938621350020795,76.18554806511206,23.814451934887952,45.69572652140495,32.78265252730575,67.21734747269424,55.62641244174038,44.37358755825962
564,KARNATAKA,Bellary,2452595,1421621,813440,608181,9626,371604,251876,623480,1116880,703258,413622,57.96395246667305,1.5439148007955348,59.601591069480975,40.39840893051902,45.53870492274509,37.03370102428193,62.96629897571807,57.21918851789612,42.78081148210388
565,KARNATAKA,Chitradurga,1659456,1087392,607188,480204,5711,349704,97644,447348,856587,513311,343276,65.52701608237881,1.2766347452095461,78.172697765498,21.827302234502,51.61854246210807,40.07485521027053,59.925144789729465,55.83892469321091,44.16107530678909
566,KARNATAKA,Davanagere,1945497,1308540,720637,587903,7320,354680,176011,530691,875207,585639,289568,67.25993409396159,1.3793337365811742,66.83361881019275,33.166381189807254,44.986293990687216,33.085658592767196,66.9143414072328,55.07183578644902,44.92816421355098
567,KARNATAKA,Shimoga,1752753,1263016,674938,588078,8791,352444,201662,554106,780598,534487,246111,72.058983781514,1.5865195468015145,63.60588046330486,36.39411953669514,44.53553923456414,31.528520442020092,68.4714795579799,53.438594602126976,46.56140539787303
568,KARNATAKA,Udupi,1177361,926429,465704,460725,9070,269817,115572,385389,513241,335399,177842,78.68691081155228,2.353466238008869,70.01159867043428,29.98840132956571,43.592492022412834,34.65077809450141,65.3492219054986,50.26871999905011,49.73128000094989
569,KARNATAKA,Chikmagalur,1137961,818345,438257,380088,4510,311660,80766,392426,565774,357889,207885,71.91327295047897,1.1492612619958922,79.41879488107311,20.58120511892688,49.718224086765716,36.743470007458804,63.25652999254119,53.55406338402508,46.44593661597492
570,KARNATAKA,Tumkur,2678980,1813391,1006024,807367,7971,685443,204799,890242,1354646,837512,517134,67.68960574547029,0.8953745161428016,76.9951316608293,23.0048683391707,50.56573770614189,38.17484420283971,61.82515579716029,55.47750043978381,44.5224995602162
571,KARNATAKA,Bangalore,9621551,7512276,4078041,3434235,430880,300576,2967384,3267960,4246927,3115361,1131566,78.07759892349996,13.184983904331753,9.197664598097896,90.8023354019021,44.139733812147334,26.64434778370337,73.35565221629663,54.2850262690029,45.7149737309971
572,KARNATAKA,Mandya,1805769,1149649,638668,510981,3367,458867,103435,562302,871408,575203,296205,63.66534146947921,0.5987885513478521,81.60508054390702,18.39491945609299,48.256892216003266,33.9915401281604,66.00845987183959,55.553303660508554,44.446696339491446
573,KARNATAKA,Hassan,1776421,1225256,668836,556420,4851,496103,132878,628981,903580,560452,343128,68.9732895524203,0.7712474621649938,78.87408363686662,21.125916363133385,50.86519468076543,37.97428008588061,62.02571991411939,54.58744947994541,45.41255052005459
574,KARNATAKA,Dakshina Kannada,2089649,1666323,864019,802304,23305,332919,317373,650292,997721,620903,376818,79.74176524382803,3.583774673531275,51.195309184181866,48.80469081581813,47.74586545395901,37.76787298252718,62.23212701747281,51.851831847727006,48.148168152272994
575,KARNATAKA,Kodagu,554519,412877,215302,197575,3308,181182,31792,212974,278938,172100,106838,74.4567814628534,1.553241240714829,85.07235625005869,14.927643749941307,50.30269476789795,38.30170145336956,61.69829854663044,52.14676525938717,47.85323474061282
576,KARNATAKA,Mysore,3001127,1962180,1063766,898414,28397,540596,380386,920982,1314268,921803,392465,65.38143837298455,3.083339305219863,58.69778128128454,41.30221871871546,43.79248195761126,29.861869877376606,70.1381301226234,54.213476847180175,45.786523152819825
577,KARNATAKA,Chamarajanagar,1020791,565279,312957,252322,1334,262680,57200,319880,481693,324326,157367,55.37656582003564,0.41703138677003876,82.11829436038515,17.881705639614857,47.18820992739944,32.66956339411202,67.33043660588798,55.36328078700961,44.6367192129904
578,KARNATAKA,Gulbarga,2566326,1427368,828359,599009,9752,400704,199303,600007,1087028,680001,407027,55.61912243417243,1.6253143713323346,66.78322086242328,33.21677913757673,42.357362236909886,37.444021681134245,62.55597831886575,58.034017856642436,41.965982143357564
579,KARNATAKA,Yadgir,1174271,510003,306751,203252,1410,207787,55208,262995,547696,317135,230561,43.43145662287496,0.5361318656248217,79.00796593091124,20.992034069088767,46.64136302437853,42.096528000934825,57.90347199906517,60.14690109666021,39.853098903339784
580,KARNATAKA,Kolar,1536401,1016219,564110,452109,5051,326567,151042,477609,717872,454048,263824,66.14282339050807,1.0575596356015067,68.37538656097351,31.624613439026483,46.724260137815584,36.75084137562128,63.24915862437872,55.51067240427506,44.48932759572494
581,KARNATAKA,Chikkaballapura,1255104,783222,442158,341064,2672,315649,94053,409702,639778,384452,255326,62.4029562490439,0.6521813415604513,77.04355848885287,22.956441511147126,50.97410254449034,39.9085307716114,60.0914692283886,56.453725763576614,43.546274236423386
582,KARNATAKA,Bangalore Rural,990923,688749,385311,303438,3729,231052,95410,326462,459891,315499,144392,69.50580418458347,1.1422462644963274,70.77454650158364,29.225453498416353,46.41036690035452,31.397004942475498,68.6029950575245,55.94360209597401,44.05639790402599
583,KARNATAKA,Ramanagara,1082636,674758,378461,296297,2844,266950,84834,351784,531459,344349,187110,62.32547227322941,0.8084506401655561,75.88463375252996,24.11536624747004,49.08935228460904,35.2068550913617,64.7931449086383,56.088405028173064,43.911594971826936
584,GOA,North Goa,818008,663060,351738,311322,23440,115859,209230,325089,327658,239125,88533,81.05788696443066,7.210333170301056,35.639163429091724,64.36083657090828,40.05559847825449,27.019941524394337,72.98005847560566,53.04768799203692,46.95231200796308
585,GOA,South Goa,640537,502427,264085,238342,17624,88620,162873,251493,249590,180411,69179,78.43840402662141,7.007749718680042,35.23756128401188,64.76243871598813,38.96574280642648,27.71705597179374,72.28294402820626,52.56186470870395,47.43813529129605
586,LAKSHADWEEP,Lakshadweep,64473,52553,28023,24530,327,5289,15953,21242,18753,15318,3435,81.51164053169543,1.5394030693908296,24.898785425101213,75.10121457489879,29.08659438834861,18.317069268916974,81.68293073108302,53.32331170437463,46.67668829562537
587,KERALA,Kasaragod,1307375,1037492,516476,521016,10378,251641,166164,417805,462998,325095,137903,79.35687924275744,2.483933892605402,60.22929356996685,39.77070643003315,35.414322592982124,29.78479388679865,70.21520611320136,49.78120313216873,50.21879686783127
588,KERALA,Kannur,2523003,2138434,1012956,1125478,32653,306288,566191,872479,824116,609377,214739,84.75748938863728,3.742554262051007,35.10548677962449,64.8945132203755,32.66409116437832,26.056890049459057,73.94310995054094,47.3690560475563,52.63094395244371
589,KERALA,Wayanad,817420,645585,328136,317449,4712,266183,11805,277988,340077,228639,111438,78.97837097208289,1.6950371958501804,95.75341381642373,4.2465861835762695,41.6037043380392,32.768461260244,67.23153873975599,50.82769890874168,49.17230109125831
590,KERALA,Kozhikode,3086293,2615443,1266939,1348504,36791,323793,666543,990336,948981,752333,196648,84.74383345975252,3.7150017771746153,32.69526706087631,67.3047329391237,30.748247169014736,20.722016563029186,79.27798343697081,48.44070392663881,51.55929607336118
591,KERALA,Malappuram,4112920,3311315,1597404,1713911,27909,634543,522586,1157129,1062424,898157,164267,80.51007556675063,2.411917772348632,54.83770608117159,45.16229391882841,25.831380138684924,15.461529483520703,84.5384705164793,48.240774435533915,51.759225564466085
592,KERALA,Palakkad,2809934,2239492,1122600,1116892,27162,665899,228442,894341,1042340,746121,296219,79.69909613535407,3.0370965884377434,74.45694651145368,25.543053488546313,37.09482144420474,28.418654181936798,71.5813458180632,50.12743961577001,49.87256038423
593,KERALA,Thrissur,3121200,2678548,1282261,1396287,56148,336748,715119,1051867,1095727,789511,306216,85.81789055491478,5.337937210692987,32.01431359668095,67.98568640331905,35.1059528386518,27.9463771541634,72.0536228458366,47.87149604935211,52.12850395064789
594,KERALA,Ernakulam,3282388,2855676,1425723,1429953,88737,369694,804997,1174691,1249343,913249,336094,86.99995247362591,7.554071666506341,31.47159550894661,68.5284044910534,38.06201460643897,26.901659512239632,73.09834048776037,49.9259369760435,50.0740630239565
595,KERALA,Idukki,1108974,923010,471881,451129,8250,391610,20823,412433,516363,331710,184653,83.23098647939446,2.000324901256689,94.95117994922812,5.048820050771883,46.56222778892923,35.760308155309346,64.23969184469065,51.1241481674088,48.875851832591195
596,KERALA,Kottayam,1974551,1749798,861592,888206,37849,481967,196194,678161,735735,530322,205413,88.61751355118201,5.581123066646416,71.06970173749302,28.930298262506987,37.26087601687675,27.919427511264246,72.08057248873575,49.23951221798173,50.760487782018274
597,KERALA,Alappuzha,2127789,1852797,890552,962245,28842,331419,392117,723536,804471,536738,267733,87.07616215705599,3.986256385307711,45.80546095840428,54.194539041595725,37.80783714926621,33.280627890874875,66.71937210912513,48.06527644420841,51.93472355579159
598,KERALA,Pathanamthitta,1197412,1062553,499181,563372,21015,414992,57848,472840,392794,281854,110940,88.73746045638427,4.4444209457744694,87.76584045343033,12.234159546569664,32.80357972026337,28.243812278191623,71.75618772180837,46.97939773357188,53.02060226642812
599,KERALA,Kollam,2635375,2240273,1074345,1165928,31542,523715,401415,925130,912025,644362,267663,85.00775032016317,3.409466777642061,56.60988185444208,43.39011814555792,34.60702936014798,29.34820865656095,70.65179134343906,47.955985721383065,52.044014278616935
600,KERALA,Thiruvananthapuram,3301427,2785408,1354857,1430551,71621,559293,609824,1169117,1231669,864101,367568,84.36981947503307,6.126076346507663,47.838924590096624,52.16107540990337,37.30717050536026,29.843082841250368,70.15691715874964,48.64124034970819,51.35875965029181
601,TAMIL NADU,Thiruvallur,3728104,2791721,1495711,1296010,75634,387237,732196,1119433,1538054,1103563,434491,74.88313094269903,6.756456170221889,34.59224446661837,65.40775553338163,41.25566239568424,28.249398265600554,71.75060173439944,53.57666471685387,46.42333528314613
602,TAMIL NADU,Chennai,4646732,3776276,1968079,1808197,217368,0,1314125,1314125,1817297,1369302,447995,81.267350903818,16.540892228669264,0.0,100.0,39.10914165051912,24.651721760394697,75.3482782396053,52.11692683479703,47.883073165202966
603,TAMIL NADU,Kancheepuram,3998252,3013382,1611461,1401921,100322,438799,774705,1213504,1673814,1181308,492506,75.36748559120335,8.2671338536997,36.15966655239703,63.84033344760297,41.86364441260831,29.42417735781873,70.57582264218128,53.47682437872132,46.52317562127868
604,TAMIL NADU,Vellore,3936331,2773928,1504355,1269573,20623,653499,486801,1140300,1689330,1123874,565456,70.46988680575896,1.8085591511005874,57.309392265193374,42.690607734806626,42.9163604381847,33.47220495699478,66.52779504300521,54.23194113185345,45.76805886814655
605,TAMIL NADU,Tiruvannamalai,2464875,1626813,909803,717010,6445,563102,147061,710163,1238177,738995,499182,65.9998174349612,0.9075381285704832,79.29193720314913,20.708062796850864,50.23285156448096,40.31588375490742,59.68411624509259,55.925481293793446,44.07451870620655
606,TAMIL NADU,Viluppuram,3458873,2195776,1234479,961297,8472,808042,159272,967314,1703249,1017383,685866,63.48241175666178,0.875827290828004,83.5346123389096,16.4653876610904,49.24288923010472,40.26809937948004,59.731900620519966,56.22062541898627,43.77937458101373
607,TAMIL NADU,Salem,3482056,2285562,1285107,1000455,20660,572813,597539,1170352,1694160,1083797,610363,65.63828956225862,1.7652808727630662,48.94365114085335,51.05634885914665,48.654013605754756,36.02747084100675,63.972529158993254,56.22717738569332,43.772822614306676
608,TAMIL NADU,Namakkal,1726601,1176131,653312,522819,8960,370357,257127,627484,898245,531463,366782,68.11828557958671,1.4279248554544817,59.02254081378967,40.977459186210325,52.02388971163575,40.83318025705682,59.16681974294319,55.54755380140478,44.452446198595226
609,TAMIL NADU,Erode,2251744,1492662,828300,664362,18604,411286,432398,843684,1195773,732083,463690,66.28915187516876,2.2050910056371817,48.74882064848924,51.25117935151076,53.104304929867695,38.77742681930433,61.22257318069567,55.49146424307714,44.50853575692287
610,TAMIL NADU,The Nilgiris,735394,569647,299447,270200,4561,112126,151979,264105,349974,212172,137802,77.46146963396492,1.7269646542095,42.455084152136465,57.54491584786354,47.58999937448497,39.374924994428156,60.62507500557184,52.56711612630278,47.43288387369722
611,TAMIL NADU,Dindigul,2159775,1481834,816180,665654,9155,443818,269724,713542,1105155,665469,439686,68.61057286059891,1.2830358969759312,62.19928189230627,37.80071810769373,51.16991353265965,39.78500753288,60.21499246712,55.07904394149412,44.92095605850588
612,TAMIL NADU,Karur,1064493,727044,401726,325318,4915,212241,152420,364661,543298,329034,214264,68.29955669036809,1.347827160019854,58.20227553810251,41.79772446189749,51.03819376924038,39.43765668196828,60.56234331803172,55.25470260396895,44.745297396031056
613,TAMIL NADU,Tiruchirappalli,2722290,2038981,1087765,951216,30046,452707,423020,875727,1213979,789206,424773,74.89947801299641,3.4309779189176535,51.69499170403562,48.30500829596438,44.594036638271454,34.99014398107381,65.0098560189262,53.34846180518602,46.65153819481398
614,TAMIL NADU,Perambalur,565223,375823,208011,167812,1507,155413,33179,188592,299726,162639,137087,66.49110174214425,0.7990794943581913,82.40699499448544,17.59300500551455,53.02791995371739,45.73744019537845,54.26255980462156,55.348129305550756,44.651870694449244
615,TAMIL NADU,Ariyalur,754894,480604,269582,211022,1749,223955,30322,254277,359851,212547,147304,63.66509735141622,0.6878325605540415,88.07520931897105,11.924790681028957,47.66907671805578,40.93472020363984,59.06527979636016,56.092333813284945,43.90766618671505
616,TAMIL NADU,Cuddalore,2605914,1815281,1000322,814959,15396,497429,260780,758209,1169880,749633,420247,69.66005017817164,2.0305746832337785,65.60578943272897,34.394210567271024,44.89326969347415,35.922231339966494,64.07776866003351,55.10562827463076,44.89437172536924
617,TAMIL NADU,Nagapattinam,1616450,1213008,640916,572092,5585,399016,118724,517740,671994,461174,210820,75.0414797859507,1.078726774056476,77.06879901108664,22.931200988913357,41.572210708651674,31.372303919380233,68.62769608061977,52.83691451334204,47.16308548665796
618,TAMIL NADU,Thiruvarur,1264277,946471,503085,443386,4416,321331,86848,408179,540168,369853,170315,74.86262899665184,1.081878293591782,78.72306022602828,21.276939773971716,42.7254470341547,31.530005479776662,68.46999452022334,53.15376804994554,46.84623195005447
619,TAMIL NADU,Thanjavur,2405890,1790998,944264,846734,13495,479070,274302,753372,974079,680483,293596,74.44222304427883,1.7912797396239841,63.59009891527692,36.40990108472308,40.48726250992356,30.140881797061635,69.85911820293836,52.722783610031954,47.27721638996805
620,TAMIL NADU,Pudukkottai,1618345,1110545,608776,501769,4494,399712,104229,503941,761693,471099,290594,68.62226533897284,0.89177106050113,79.31722165888468,20.68277834111533,47.066169450889646,38.15106611193749,61.84893388806252,54.81776965363853,45.18223034636147
621,TAMIL NADU,Sivaganga,1339101,959744,526304,433440,5773,309224,143193,452417,620171,391305,228866,71.67077016595462,1.2760351622507553,68.3493325847614,31.650667415238598,46.31248875178198,36.90369269120936,63.09630730879064,54.83795678847693,45.16204321152307
622,TAMIL NADU,Madurai,3038252,2273430,1223810,1049620,34097,417718,592723,1010441,1354632,902704,451928,74.82690705050142,3.3744671880891612,41.34016731308409,58.65983268691591,44.58590005042373,33.36168051544626,66.63831948455375,53.830995456204946,46.169004543795054
623,TAMIL NADU,Theni,1245899,870080,479403,390677,4667,189328,221295,410623,591642,368900,222742,69.83551636208072,1.136565657549626,46.107500066971404,53.892499933028596,47.4871558609486,37.648104766057855,62.351895233942145,55.098726553880105,44.9012734461199
624,TAMIL NADU,Virudhunagar,1942288,1398788,760375,638413,10219,363782,370942,734724,950158,579111,371047,72.01753807880192,1.3908624190852619,49.51274219979203,50.48725780020797,48.919521718715245,39.05108413548062,60.94891586451937,54.35955984752514,45.64044015247486
625,TAMIL NADU,Ramanathapuram,1353445,978946,536487,442459,5172,290478,126761,417239,602977,392751,210226,72.32994321897085,1.239577316597921,69.61909121630528,30.380908783694714,44.551274710091654,34.86467974732037,65.13532025267962,54.80251208953303,45.19748791046697
626,TAMIL NADU,Thoothukkudi,1750176,1349697,703106,646591,11455,336078,300661,636739,748095,503727,244368,77.11778701113488,1.7990102695138825,52.7811238199639,47.21887618003609,42.7439868904613,32.66537003990135,67.33462996009865,52.09361804908805,47.90638195091195
627,TAMIL NADU,Tirunelveli,3077233,2273457,1210710,1062747,19070,547962,516705,1064667,1436454,876175,560279,73.87991094596997,1.7911703847306246,51.46792377334884,48.53207622665115,46.6800531516463,39.004312007206636,60.99568799279337,53.25414116035623,46.745858839643766
628,TAMIL NADU,Kanniyakumari,1870374,1548738,780541,768197,15673,104253,493788,598041,679620,524629,154991,82.8036531731087,2.620723328333676,17.432416840985816,82.56758315901418,36.33604829836172,22.80553838909979,77.1944616109002,50.398518019187236,49.601481980812764
629,TAMIL NADU,Dharmapuri,1506843,917709,527599,390110,3651,396819,91107,487926,751170,446057,305113,60.902761601573616,0.748269204756459,81.32770133175933,18.672298668240675,49.85058164652854,40.61836867819535,59.38163132180465,57.49088218596526,42.50911781403473
630,TAMIL NADU,Krishnagiri,1879809,1187958,667062,520896,9619,437988,142552,580540,877779,561634,316145,63.195675730885426,1.6569056395769457,75.44493058187204,24.55506941812795,46.695116365545644,36.0164688378282,63.9835311621718,56.15198517119292,43.84801482880708
631,TAMIL NADU,Coimbatore,3458045,2635907,1394790,1241117,63273,284795,884957,1169752,1567950,1083125,484825,76.22535276435094,5.409095261217763,24.346613641182064,75.65338635881794,45.342093581778144,30.92094773430275,69.07905226569724,52.91499282789567,47.085007172104326
632,TAMIL NADU,Tiruppur,2479052,1760566,959623,800943,17181,356886,538022,894908,1266137,819783,446354,71.0177116091151,1.919862153428062,39.87963008488023,60.12036991511977,51.073434522551366,35.253215094417115,64.74678490558289,54.50650529432012,45.49349470567988
633,PONDICHERRY,Yanam,55626,39274,19919,19355,207,0,15519,15519,16760,14047,2713,70.60367454068242,1.3338488304658807,0.0,100.0,30.12979541940819,16.187350835322196,83.8126491646778,50.71803228599073,49.28196771400927
634,PONDICHERRY,PONDICHERRY,950289,726649,380946,345703,15437,87296,203741,291037,348105,256652,91453,76.46610662651047,5.304136587444209,29.994811656249894,70.0051883437501,36.63148789473518,26.27167090389394,73.72832909610607,52.425036021517954,47.574963978482046
635,PONDICHERRY,Mahe,41816,36470,16610,19860,574,0,12110,12110,11802,9093,2709,87.21541993495313,4.7398843930635834,0.0,100.0,28.223646451119187,22.95373665480427,77.04626334519573,45.54428297230601,54.45571702769399
636,PONDICHERRY,Karaikal,200222,154916,79903,75013,1868,35618,33715,69333,68301,53139,15162,77.3721169501853,2.6942437223255884,51.37236236712677,48.62763763287323,34.11263497517755,22.198796503711513,77.80120349628848,51.57827467788996,48.42172532211005
637,ANDAMAN AND NICOBAR ISLANDS,Nicobars,36842,25332,15397,9935,57,15958,0,15958,17125,12714,4411,68.7584821670919,0.3571876174959268,100.0,0.0,46.48227566364475,25.757664233576644,74.24233576642337,60.78083057003,39.219169429969995
638,ANDAMAN AND NICOBAR ISLANDS,North  AND Middle Andaman,105597,78683,43186,35497,388,39091,1094,40185,38579,30612,7967,74.51253350000474,0.9655344033843475,97.277591140973,2.722408859027,36.53418184228719,20.65113144456829,79.34886855543171,54.886061792255006,45.113938207745
639,ANDAMAN AND NICOBAR ISLANDS,South Andaman,238142,190266,105794,84472,2789,34901,50631,85532,96831,77563,19268,79.89602842001831,3.2607678997334335,40.80461113969041,59.19538886030959,40.66103417288844,19.898586196569283,80.10141380343072,55.603208140182694,44.396791859817306
